TTCCAACCATT -> TCCAACCATTC
AGAGAACTTAA -> GAGAACTTAAC
TCCAGCAACCC -> CCAGCAACCCT
AACTGAAATTT -> ACTGAAATTTA
CAAGTGGATCA -> AAGTGGATCAG
ATTAGCTAAGC -> TTAGCTAAGCC
ATATCGGGGAC -> TATCGGGGACC
TCTGGTGCATA -> CTGGTGCATAA
CGCAGACCTGC -> GCAGACCTGCT
TTCTTATAGTG -> TCTTATAGTGG
AAGCAGAATAA -> AGCAGAATAAG
ACTCTATGTTT -> CTCTATGTTTA
CGTGGCACAAT -> GTGGCACAATC
TACGTGCGCTT -> ACGTGCGCTTG
ACGGACGCAGC -> CGGACGCAGCT
AACCTAGTTGG -> ACCTAGTTGGT
ACAGTATCGCA -> CAGTATCGCAA
ACGATTACGAT -> CGATTACGATA
GTCTCATGTAG -> TCTCATGTAGC
CGGACGCAGCT -> GGACGCAGCTG
GACCCCCTCTC -> ACCCCCTCTCT
TCCGTTGCCCG -> CCGTTGCCCGC
ACTTACTAAAC -> CTTACTAAACT
AAGCAGCGCGT -> AGCAGCGCGTT
GTTCTTACAGG -> TTCTTACAGGA
GTAGACCCATG -> TAGACCCATGC
GGACATGTGGG -> GACATGTGGGG
GAAGAAATGCA -> AAGAAATGCAA
ACATTGGACGA -> CATTGGACGAT
TACGCATCAGT -> ACGCATCAGTA
ATTAGCGCAAG -> TTAGCGCAAGT
GATCGACGTCT -> ATCGACGTCTA
AGAAATGCAAG -> GAAATGCAAGC
AAGGTATAACG -> AGGTATAACGC
GGGATACTGGC -> GGATACTGGCG
CATACGGTCTC -> ATACGGTCTCA
GACCTTGGCAA -> ACCTTGGCAAG
TAATAAATGAC -> AATAAATGACA
TACGGGTACCC -> ACGGGTACCCT
TTTCCAAGACC -> TTCCAAGACCG
TGGAATGCGAG -> GGAATGCGAGG
CGCGATCGCTC -> GCGATCGCTCA
CCTTAACTGAA -> CTTAACTGAAA
GGGCTTAGACA -> GGCTTAGACAA
AATACTCAAAC -> ATACTCAAACG
CTCACTTTCGT -> TCACTTTCGTA
CCCCATACTGT -> CCCATACTGTT
AGGCTGCGTTT -> GGCTGCGTTTT
TATAACGCCCA -> ATAACGCCCAG
AAGAATTGTTA -> AGAATTGTTAA
CGCGTTCCAAC -> GCGTTCCAACC
CCGAACTACTA -> CGAACTACTAC
CCGAGTCGCAA -> CGAGTCGCAAC
ACCCGAGGTTA -> CCCGAGGTTAT
CGTAGCGTATA -> GTAGCGTATAA
CGAGGAAACTC -> GAGGAAACTCT
TGTGAAACGCA -> GTGAAACGCAG
AGAAGTAGGTT -> GAAGTAGGTTC
GAGGCTCCCTC -> AGGCTCCCTCG
AGCTGATAGGG -> GCTGATAGGGG
TGACGGCCTTA -> GACGGCCTTAC
TGAAGAAATGC -> GAAGAAATGCA
AGGTTCCGTTG -> GGTTCCGTTGC
CTGTCAGTATT -> TGTCAGTATTG
GCAGAAGACAA -> CAGAAGACAAG
CCGGGTCCCCA -> CGGGTCCCCAT
CCATCCATTGA -> CATCCATTGAA
CCTCTGTGACG -> CTCTGTGACGA
GAGTACGCTAC -> AGTACGCTACA
CCATGATTACC -> CATGATTACCG
TAACCTGTATT -> AACCTGTATTC
GCGTGTTTAAT -> CGTGTTTAATA
ACCAATCCGAC -> CCAATCCGACG
TGACGACCAGT -> GACGACCAGTG
GATCAGAGAAC -> ATCAGAGAACT
CGGTACACATC -> GGTACACATCT
CAACCCTGAGG -> AACCCTGAGGG
AGCAGGAGACT -> GCAGGAGACTT
TTTGCTATGGG -> TTGCTATGGGA
GAGCAGTGTTA -> AGCAGTGTTAT
ATGGGTCTTCT -> TGGGTCTTCTG
GCAGGGGCGCT -> CAGGGGCGCTT
ACCCTTTCCAA -> CCCTTTCCAAG
AAATCCTACCC -> AATCCTACCCT
CTCTGGAGGCG -> TCTGGAGGCGA
CAGGGGCGCTT -> AGGGGCGCTTA
TACAGTATCGC -> ACAGTATCGCA
TTGTTATAATT -> TGTTATAATTA
CCTAAGGCAGA -> CTAAGGCAGAC
AAGCCGTGAAG -> AGCCGTGAAGA
CAGGCGAGCAG -> AGGCGAGCAGT
CTAAGGCAGAC -> TAAGGCAGACC
AGGCTCACTTT -> GGCTCACTTTC
GACGGGAAGGT -> ACGGGAAGGTC
GGCCGGCCACC -> GCCGGCCACCC
CATTGGACGAT -> ATTGGACGATT
ATATATCGGGG -> TATATCGGGGA
AAGGTCTAGGG -> AGGTCTAGGGT
TCTAGGGTGGC -> CTAGGGTGGCA
GCATCAGTAAG -> CATCAGTAAGG
CTACCGGGTCC -> TACCGGGTCCC
GTGCAGCTACC -> TGCAGCTACCG
AGGATATCATC -> GGATATCATCC
TGTTTGCTATG -> GTTTGCTATGG
GTGAAACGCAG -> TGAAACGCAGA
TAAGATTTAAC -> AAGATTTAACC
TCGGCAGAAGA -> CGGCAGAAGAC
GTAGGAAGCTT -> TAGGAAGCTTG
GCTCGGAGGCT -> CTCGGAGGCTC
AGCTATACCGT -> GCTATACCGTG
GACCCGTGGCA -> ACCCGTGGCAC
ATAATACGCAT -> TAATACGCATC
AGTGGCATTTC -> GTGGCATTTCA
TTAGACAAAAG -> TAGACAAAAGC
TAACTAATAAA -> AACTAATAAAT
TGAAGCAGCGC -> GAAGCAGCGCG
GTATAACGCCC -> TATAACGCCCA
TGAGTACGCTA -> GAGTACGCTAC
GTTTAATACAG -> TTTAATACAGC
CTCCAGCAAAC -> TCCAGCAAACA
GGGCTGACGGC -> GGCTGACGGCC
CATCTCGTGAC -> ATCTCGTGACC
ACCCTGAGGGG -> CCCTGAGGGGG
GACTCTATGTT -> ACTCTATGTTT
TAACATTGGAC -> AACATTGGACG
GGACGCAGCTG -> GACGCAGCTGG
GTGCATAAACC -> TGCATAAACCT
CTCAAGTGATG -> TCAAGTGATGC
AAGTGTAGATT -> AGTGTAGATTC
GAAAACTCTTC -> AAAACTCTTCC
GCTGCCGGGCT -> CTGCCGGGCTT
AGCGCTGCATC -> GCGCTGCATCG
AAACTCTCGTC -> AACTCTCGTCT
ATAGGGGAGTG -> TAGGGGAGTGC
AAGGAGTCACA -> AGGAGTCACAA
TGACTCGATTA -> GACTCGATTAT
TTAACCATAAT -> TAACCATAATA
ATCTGGACTAA -> TCTGGACTAAA
CCTGTCAGTAT -> CTGTCAGTATT
CAGGCTCACTT -> AGGCTCACTTT
GAGCTATACCG -> AGCTATACCGT
TTACACCGCAG -> TACACCGCAGG
CAGTATCGCAA -> AGTATCGCAAA
CTAAAGTCTGG -> TAAAGTCTGGT
TACACATCTCG -> ACACATCTCGT
TGTAACTAATA -> GTAACTAATAA
ACCCAGGCTCA -> CCCAGGCTCAC
CAGCATGCTGC -> AGCATGCTGCG
GTATTGCGACG -> TATTGCGACGA
TTCTCTGGAGG -> TCTCTGGAGGC
AATTGTTAATC -> ATTGTTAATCC
AAAGGCTGCGT -> AAGGCTGCGTT
TAAAGGCTGCG -> AAAGGCTGCGT
CTTTCCCGAGC -> TTTCCCGAGCA
ACTACTACCAT -> CTACTACCATC
ACTACTACCAG -> CTACTACCAGC
TTAGGGGCAAG -> TAGGGGCAAGA
TACTCCAGCAA -> ACTCCAGCAAC
AAGTGGATCAG -> AGTGGATCAGA
ATGTATGTAGG -> TGTATGTAGGA
AAGCCGGGAAG -> AGCCGGGAAGT
ATTAACCTGTA -> TTAACCTGTAT
TCCCTCGGACT -> CCCTCGGACTC
CTGTGAAACGC -> TGTGAAACGCA
CTTACTAAACT -> TTACTAAACTT
ATAACATTGGA -> TAACATTGGAC
TACGGTCTCAT -> ACGGTCTCATC
GACCAATCCGA -> ACCAATCCGAC
AGAATAAGATT -> GAATAAGATTT
GGTCCCCATCA -> GTCCCCATCAA
ATTCCGCCTAG -> TTCCGCCTAGG
TAGGGGCAAGA -> AGGGGCAAGAA
CTGGAATGCGA -> TGGAATGCGAG
TCCATACGGTC -> CCATACGGTCT
CCGTTTCGCCT -> CGTTTCGCCTT
GGGTTTTGACT -> GGTTTTGACTC
CCTCTCTATCT -> CTCTCTATCTG
CGCTCAAATCC -> GCTCAAATCCT
ACCCCCTCTCT -> CCCCCTCTCTA
GCATAATTACG -> CATAATTACGA
GCTGCATCGAC -> CTGCATCGACG
CGACACCAGCT -> GACACCAGCTG
TTTCCCGAGCA -> TTCCCGAGCAC
AAGATTTAACC -> AGATTTAACCA
TTTGACTCGAT -> TTGACTCGATT
AGCCGTGAAGA -> GCCGTGAAGAA
TCAATGTATAC -> CAATGTATACT
GCATCGACGGC -> CATCGACGGCT
CGTTTCGCCTT -> GTTTCGCCTTG
TTACCAAACCA -> TACCAAACCAT
AAGTGATGCCG -> AGTGATGCCGT
GACGGCTTTTG -> ACGGCTTTTGC
ACGACCCTCTA -> CGACCCTCTAA
CTGGACTAAAG -> TGGACTAAAGT
ACCGAAAACAA -> CCGAAAACAAT
GCTATGTATGT -> CTATGTATGTA
AAATTATAGGT -> AATTATAGGTA
AACCATATTGT -> ACCATATTGTT
ATACGCCGATT -> TACGCCGATTG
AGGGGGTTTTG -> GGGGGTTTTGA
GCCTTAACTGA -> CCTTAACTGAA
CTTAGACAAAA -> TTAGACAAAAG
TTTTGCTAACT -> TTTGCTAACTA
GACTAAAGTCT -> ACTAAAGTCTG
CGAGCACCAGG -> GAGCACCAGGG
AAGGACATGTG -> AGGACATGTGG
CTATACCGTGC -> TATACCGTGCA
CGGCCTGCTCG -> GGCCTGCTCGT
GTGACGACCAG -> TGACGACCAGT
AGTCGCAACCA -> GTCGCAACCAT
ACTCTTCCCCT -> CTCTTCCCCTA
ACTCGAATCGT -> CTCGAATCGTT
AATCCGACGAT -> ATCCGACGATT
TACGCCGATTG -> ACGCCGATTGG
GTACAGTATCG -> TACAGTATCGC
ACCGCAGGCGA -> CCGCAGGCGAG
GTGTTTAATAC -> TGTTTAATACA
AGTACGCTACA -> GTACGCTACAT
GTACATATGTG -> TACATATGTGC
AGGAAACTCTC -> GGAAACTCTCG
GCTGTAGGTAG -> CTGTAGGTAGA
CGGGGAGTCGT -> GGGGAGTCGTC
TGGCAATATTT -> GGCAATATTTC
GGCAAGAATTG -> GCAAGAATTGT
GGAAGTATCGA -> GAAGTATCGAT
ACACTTAATGC -> CACTTAATGCA
AATACTGCGCA -> ATACTGCGCAC
ACCATAACCGA -> CCATAACCGAA
GACCCCTGTCA -> ACCCCTGTCAG
AGTCTGATATG -> GTCTGATATGC
AACCTGTATTC -> ACCTGTATTCC
TGTAGGAAGCT -> GTAGGAAGCTT
GAGCCTCTCGG -> AGCCTCTCGGA
CCAAACCATGA -> CAAACCATGAT
TAATTTATGGG -> AATTTATGGGT
GCCATAATCCA -> CCATAATCCAC
GTAGAACCTCT -> TAGAACCTCTG
GCTATACCGTG -> CTATACCGTGC
CATGATTACCG -> ATGATTACCGA
GGAAACTCTCG -> GAAACTCTCGT
AATCAAGCCGG -> ATCAAGCCGGG
CAGCTGCGTCC -> AGCTGCGTCCC
TTAGCGCAAGT -> TAGCGCAAGTG
ACATATGTGCA -> CATATGTGCAT
TGTTAGCAGAA -> GTTAGCAGAAC
TAACCACGTCC -> AACCACGTCCG
ATCCATTGAAG -> TCCATTGAAGC
TTGAAGCAGCG -> TGAAGCAGCGC
AACTGGCCTTG -> ACTGGCCTTGC
TACCGAAAACA -> ACCGAAAACAA
AGCCCACCACG -> GCCCACCACGG
CTTGGCAAGGC -> TTGGCAAGGCT
CAGCTGGGTAC -> AGCTGGGTACT
AGTAAGGTATA -> GTAAGGTATAA
TTCTTACAGGA -> TCTTACAGGAT
GCACTCGAATC -> CACTCGAATCG
TGCATGGTCTG -> GCATGGTCTGA
CAGAAGACAAG -> AGAAGACAAGC
CTGGCAGTCAA -> TGGCAGTCAAT
GCAGACCGTAA -> CAGACCGTAAA
CAGAACGACAC -> AGAACGACACG
GGGTTCTTACA -> GGTTCTTACAG
GACTGGAATGC -> ACTGGAATGCG
TTGGTAAGCTA -> TGGTAAGCTAA
CGTGGGGGATA -> GTGGGGGATAC
GAACTTAACCA -> AACTTAACCAT
GAGTCGTCGAT -> AGTCGTCGATT
TGCTGTAGGTA -> GCTGTAGGTAG
AGGACCCCCTC -> GGACCCCCTCT
TCGCCTTGTAA -> CGCCTTGTAAC
CAATTCTTATA -> AATTCTTATAG
ACTAGACGGGT -> CTAGACGGGTT
CATATTGTTTG -> ATATTGTTTGC
CCCAGGTTCCG -> CCAGGTTCCGT
TTAATCCGTAG -> TAATCCGTAGA
CGACCAATCCG -> GACCAATCCGA
ATTACGATACT -> TTACGATACTA
TGGGTCTTCTG -> GGGTCTTCTGT
GTTTCGCCTTG -> TTTCGCCTTGT
CTCTATCTGGC -> TCTATCTGGCC
GGTACGGACGC -> GTACGGACGCA
ATAAGATTTAA -> TAAGATTTAAC
ACGCCCAGGTT -> CGCCCAGGTTC
GTACGGACGCA -> TACGGACGCAG
ATCTGGCCATA -> TCTGGCCATAA
GGGTTCCTATC -> GGTTCCTATCT
AAACACTTCAG -> AACACTTCAGC
GTTTTAGGGGC -> TTTTAGGGGCA
GGAGGCTCCCT -> GAGGCTCCCTC
ATAACCGAACT -> TAACCGAACTA
TTCCGTTGCCC -> TCCGTTGCCCG
ACCTGCTGTAG -> CCTGCTGTAGG
AGGCAGACCGT -> GGCAGACCGTA
AGATTTAACCA -> GATTTAACCAC
AGTTGGTAGTT -> GTTGGTAGTTA
TGGGAGAAGTT -> GGGAGAAGTTA
GGGAAGGTCTA -> GGAAGGTCTAG
AGGCAATTCTT -> GGCAATTCTTA
TTATCGTCTCA -> TATCGTCTCAA
ACAAAAGCCCA -> CAAAAGCCCAC
ACGGCTTTTGC -> CGGCTTTTGCT
ACACATCTCGT -> CACATCTCGTG
AATGCACATTA -> ATGCACATTAG
CCCACCGCGTT -> CCACCGCGTTC
TCGATTGGAGA -> CGATTGGAGAC
TTTTGACTCGA -> TTTGACTCGAT
TCCGCCTAGGG -> CCGCCTAGGGC
CACGTCCGTTT -> ACGTCCGTTTC
TTATGGGGTCC -> TATGGGGTCCT
CCCAGGCTCAC -> CCAGGCTCACT
GACTTTACGGG -> ACTTTACGGGT
TTAATTGCCTT -> TAATTGCCTTT
CAACCATTCTC -> AACCATTCTCT
ATTGAGCTATA -> TTGAGCTATAC
CGTGAAGAAAT -> GTGAAGAAATG
GGAGATGTAGA -> GAGATGTAGAC
ACCAGGGGCTG -> CCAGGGGCTGA
CTCTAAGCTGA -> TCTAAGCTGAT
GCTCAAATCCT -> CTCAAATCCTA
AATACGCATCA -> ATACGCATCAG
TGCGTCCCTTG -> GCGTCCCTTGT
CGCAAACCCAC -> GCAAACCCACA
AATTAACATGG -> ATTAACATGGG
AGCATGCTGCG -> GCATGCTGCGG
TCTCGTGACCC -> CTCGTGACCCG
CTCCCTCGGAC -> TCCCTCGGACT
TCGATGATGAA -> CGATGATGAAG
ATGTTTACACC -> TGTTTACACCG
AAATGACAAAC -> AATGACAAACA
AGGAGTCACAA -> GGAGTCACAAG
AGTATTGCGAC -> GTATTGCGACG
AACTTAACCAT -> ACTTAACCATA
TGGATCAGAGA -> GGATCAGAGAA
GACGACCAGTG -> ACGACCAGTGG
GAATGCGAGGA -> AATGCGAGGAA
GTCGATTGGAG -> TCGATTGGAGA
GTCCCTTGTTA -> TCCCTTGTTAT
CATAATCCACA -> ATAATCCACAC
AGCTGCCGGGC -> GCTGCCGGGCT
TGGACTAAAGT -> GGACTAAAGTC
GATAGGGGAGT -> ATAGGGGAGTG
CAGAGAACTTA -> AGAGAACTTAA
CTGGCGGGTTC -> TGGCGGGTTCT
GTTATGGGGTC -> TTATGGGGTCC
GATTACCGAAA -> ATTACCGAAAA
GGGTCCCCATC -> GGTCCCCATCA
TCTGGCCATAA -> CTGGCCATAAT
ACAAACACTTC -> CAAACACTTCA
GCAGCTACCGG -> CAGCTACCGGG
CATCAGTAAGG -> ATCAGTAAGGT
AACGCAGGGGC -> ACGCAGGGGCG
GCGCTTGTCGT -> CGCTTGTCGTA
AGCCGGCTAGC -> GCCGGCTAGCA
AGCGGTACGGA -> GCGGTACGGAC
CATTATTAACC -> ATTATTAACCT
CTAGAGTCTGA -> TAGAGTCTGAT
AACTTTCCCGA -> ACTTTCCCGAG
CTACCCTTTCC -> TACCCTTTCCA
GGGAAAACTCT -> GGAAAACTCTT
ACCACGTCCGT -> CCACGTCCGTT
ATCGATGATGA -> TCGATGATGAA
AAGCTAAGTCG -> AGCTAAGTCGG
TCTGGACTAAA -> CTGGACTAAAG
ATGTAGGAAGC -> TGTAGGAAGCT
CCCCTAAGGCA -> CCCTAAGGCAG
GCCCGAGGCGG -> CCCGAGGCGGG
ACATGTGGGGA -> CATGTGGGGAC
GGAGTCGTCGA -> GAGTCGTCGAT
TTAGTAACTCC -> TAGTAACTCCG
GGGTGGCAATA -> GGTGGCAATAT
CCCTGTCAGTA -> CCTGTCAGTAT
ATTGCGACGAA -> TTGCGACGAAT
CCAGCAAACAT -> CAGCAAACATT
GTTTTGACTCG -> TTTTGACTCGA
TTTACGGGTAC -> TTACGGGTACC
GATCGCTCAAA -> ATCGCTCAAAT
GTCGGGGAGTC -> TCGGGGAGTCG
TATCATCCCCA -> ATCATCCCCAT
TTAGGTGACCT -> TAGGTGACCTT
CATAACCGAAC -> ATAACCGAACT
AACTCTCGTCT -> ACTCTCGTCTC
AGGTCTAGGGT -> GGTCTAGGGTG
GGTTCCGTTGC -> GTTCCGTTGCC
TCGACGGCTTT -> CGACGGCTTTT
ACAAGGAGTCA -> CAAGGAGTCAC
TACATATGTGC -> ACATATGTGCA
CCAATCCGACG -> CAATCCGACGA
CCGGGCTTAGA -> CGGGCTTAGAC
CTGGCCTTGCT -> TGGCCTTGCTT
TGGGGACGGGA -> GGGGACGGGAA
GCTTGTCGTAC -> CTTGTCGTACA
CACTCGAATCG -> ACTCGAATCGT
TCACTTTCGTA -> CACTTTCGTAG
TATTAGCTAAG -> ATTAGCTAAGC
GGAAAACTCTT -> GAAAACTCTTC
TTGCTCGGAGG -> TGCTCGGAGGC
GGCTTAGTAAC -> GCTTAGTAACT
AACCGAACTAC -> ACCGAACTACT
AGAACTTAACC -> GAACTTAACCA
CTTTCAATAAC -> TTTCAATAACA
GCAGCTGGGTA -> CAGCTGGGTAC
CTCCAGCAACC -> TCCAGCAACCC
AATCCACACTT -> ATCCACACTTA
GCGGGTTCTTA -> CGGGTTCTTAC
GCTGCGTTTTA -> CTGCGTTTTAG
GCAGTCAATAC -> CAGTCAATACT
GAGTCACAAGA -> AGTCACAAGAC
GCCCAGGTTCC -> CCCAGGTTCCG
TTAATACAGCG -> TAATACAGCGA
GCATTTCATAA -> CATTTCATAAT
AATGCGAGGAA -> ATGCGAGGAAA
TAGGATATCAT -> AGGATATCATC
GAAATCAAGCC -> AAATCAAGCCG
TATTTCTGTAC -> ATTTCTGTACA
AAAGCCCACCA -> AAGCCCACCAC
GACCCGAGGTT -> ACCCGAGGTTA
CGCTGCATCGA -> GCTGCATCGAC
CGTGCGCTTGT -> GTGCGCTTGTC
TAGGCTGGCAG -> AGGCTGGCAGT
GAGACGTTAGG -> AGACGTTAGGC
TTTAATTGCCT -> TTAATTGCCTT
TAGGGCCGGCC -> AGGGCCGGCCA
AGCTGTTGGTC -> GCTGTTGGTCC
CGACGTCTAGA -> GACGTCTAGAG
GGGGGTTTTGA -> GGGGTTTTGAC
ATTGGTAAGCT -> TTGGTAAGCTA
CTGATAGGGGA -> TGATAGGGGAG
GTTTGCTCGGA -> TTTGCTCGGAG
CTGTTGGTCCA -> TGTTGGTCCAT
GCAAGAATTGT -> CAAGAATTGTT
GTACCCTTAAG -> TACCCTTAAGT
TAAAGTCTGGT -> AAAGTCTGGTG
GCGACGAATAC -> CGACGAATACT
CCTAGTTGGTA -> CTAGTTGGTAG
GGGCAAGAATT -> GGCAAGAATTG
AGGGCCGGCCA -> GGGCCGGCCAC
CGACGAATACT -> GACGAATACTG
GGGGACCCCTG -> GGGACCCCTGT
TAATTAGCAGG -> AATTAGCAGGA
GCATAAGGATC -> CATAAGGATCA
GCTATGGGAGA -> CTATGGGAGAT
CAACCATCCAT -> AACCATCCATT
TGTTTACACCG -> GTTTACACCGC
CAAACCCACAC -> AAACCCACACT
ACCGGGGCGAG -> CCGGGGCGAGC
TGTTATAATTA -> GTTATAATTAA
TCAATAACATT -> CAATAACATTG
AGTCGGGCTAT -> GTCGGGCTATA
GGGGTTTTGAC -> GGGTTTTGACT
ACGCTACATGT -> CGCTACATGTT
GGGACTGGAAT -> GGACTGGAATG
TAATTGCCTTT -> AATTGCCTTTG
TCTAAGGACAT -> CTAAGGACATG
TAAACTTAGGT -> AAACTTAGGTG
CTAAACTTAGG -> TAAACTTAGGT
GAGACTTTACG -> AGACTTTACGG
ACCTGTATTCC -> CCTGTATTCCG
GGTGGTACATA -> GTGGTACATAT
TCCCTTGTTAT -> CCCTTGTTATA
AGCACCAGGGG -> GCACCAGGGGC
TTATACTGGAT -> TATACTGGATT
TTGGTCCATGA -> TGGTCCATGAT
ATCATCCCCAT -> TCATCCCCATA
GGGGCGCTTAA -> GGGCGCTTAAT
CCGCCTAGGGC -> CGCCTAGGGCC
TAACTACTACC -> AACTACTACCA
TGACCCGTGGC -> GACCCGTGGCA
AGGTTCTAAGG -> GGTTCTAAGGA
CGTCCCTTGTT -> GTCCCTTGTTA
TCCGTTTCGCC -> CCGTTTCGCCT
CTCGATTATGC -> TCGATTATGCA
ATGTTTGCTAT -> TGTTTGCTATG
AACTTACGTGC -> ACTTACGTGCG
TTATTAACCTG -> TATTAACCTGT
TTGCCTTTGGG -> TGCCTTTGGGA
CGGCTTTTGCT -> GGCTTTTGCTA
TCAGAGAACTT -> CAGAGAACTTA
ACAACTTTCCC -> CAACTTTCCCG
GGCATTTCATA -> GCATTTCATAA
GCTAAGCCGTG -> CTAAGCCGTGA
AACATGGGGTT -> ACATGGGGTTA
GGCTATATATC -> GCTATATATCG
GACAAAAGCCC -> ACAAAAGCCCA
AGACCGGGGCG -> GACCGGGGCGA
ATTATTAACCT -> TTATTAACCTG
ATAATCCACAC -> TAATCCACACT
AAACTTAGGTG -> AACTTAGGTGA
CGGCCGAGTCG -> GGCCGAGTCGC
ACCTCCCAAGC -> CCTCCCAAGCG
ACCAGCTTTCA -> CCAGCTTTCAA
CGAGACGTTAG -> GAGACGTTAGG
AGACGCGATCG -> GACGCGATCGC
TCGCAACCATC -> CGCAACCATCC
CGTAAATTATA -> GTAAATTATAG
AATTTATGGGT -> ATTTATGGGTC
CGCCCAGGTTC -> GCCCAGGTTCC
GGGAGCCTCTC -> GGAGCCTCTCG
TGCAAGCTGTT -> GCAAGCTGTTG
TGCTCCTCCAT -> GCTCCTCCATA
AATCCGTAGAA -> ATCCGTAGAAC
ATAGGTAAGGA -> TAGGTAAGGAA
TTAAGCGGGGG -> TAAGCGGGGGA
TCGCAAACCCA -> CGCAAACCCAC
ATACCGTGCAT -> TACCGTGCATG
CACATCTCGTG -> ACATCTCGTGA
ACTAAAGTCTG -> CTAAAGTCTGG
AGTCAATACTC -> GTCAATACTCA
AGTATCGCAAA -> GTATCGCAAAC
TGTCGTACAAG -> GTCGTACAAGG
AAACTCTTCCC -> AACTCTTCCCC
AATCAGCCTTA -> ATCAGCCTTAA
AAGTTACGGAC -> AGTTACGGACA
ATTGAAGCAGC -> TTGAAGCAGCG
TATCGTCTCAA -> ATCGTCTCAAG
CTGTAGGTAGA -> TGTAGGTAGAG
TAAGCTGATAG -> AAGCTGATAGG
ACCGCGTTCCA -> CCGCGTTCCAA
GTGATGCCGTA -> TGATGCCGTAG
GTTCTAAGGAC -> TTCTAAGGACA
CGTCGATTGGA -> GTCGATTGGAG
GCGGCCGAGTC -> CGGCCGAGTCG
TCTGTACAGTA -> CTGTACAGTAT
AACTTACTAAA -> ACTTACTAAAC
TTGGACCCGAG -> TGGACCCGAGG
TTATGCACCAT -> TATGCACCATA
CTAAGCCGTGA -> TAAGCCGTGAA
TTCCGCCTAGG -> TCCGCCTAGGG
TAATACGCATC -> AATACGCATCA
ATTAGCAGGAG -> TTAGCAGGAGA
CTATATATCGG -> TATATATCGGG
GTGGTACATAT -> TGGTACATATG
TACGGACGCAG -> ACGGACGCAGC
GCAAGCTGTTG -> CAAGCTGTTGG
CTTGCTTGACC -> TTGCTTGACCA
CAGTCAATACT -> AGTCAATACTC
GGGGAGCCTCT -> GGGAGCCTCTC
GGCTGCGTTTT -> GCTGCGTTTTA
TCTATGTTTAC -> CTATGTTTACA
ATTTCAGCCGG -> TTTCAGCCGGC
CCACACTCGAC -> CACACTCGACA
GAGGCAATTCT -> AGGCAATTCTT
CAGCCGGCTAG -> AGCCGGCTAGC
ACCCCTGTCAG -> CCCCTGTCAGT
AGGATCAGAAG -> GGATCAGAAGT
TCAGAAGTAGG -> CAGAAGTAGGT
GCGACAGCATG -> CGACAGCATGC
GACGGGTTCCT -> ACGGGTTCCTA
GCATGCTGCGG -> CATGCTGCGGT
TCAAGTGATGC -> CAAGTGATGCC
GGACGATTCTC -> GACGATTCTCA
TTGACCATTAT -> TGACCATTATT
CGTTAGGCTGG -> GTTAGGCTGGC
CATAAACCTCC -> ATAAACCTCCA
ATGCGAGGAAA -> TGCGAGGAAAC
AGACCGCAGAC -> GACCGCAGACC
CGACGGCTTTT -> GACGGCTTTTG
TTAACCTGTAT -> TAACCTGTATT
AATAATTAGCA -> ATAATTAGCAG
TGCTCGGAGGC -> GCTCGGAGGCT
TGACGCCCCCA -> GACGCCCCCAC
AAGGCAGACCG -> AGGCAGACCGT
CGGCCTTACAC -> GGCCTTACACG
TTAACTGAAAT -> TAACTGAAATT
TTGAAATCAAG -> TGAAATCAAGC
ATATCATCCCC -> TATCATCCCCA
AAACTTACTAA -> AACTTACTAAA
GGGAGAAGTTA -> GGAGAAGTTAC
AGGTAAGGAAG -> GGTAAGGAAGT
GAGGGGGTTTT -> AGGGGGTTTTG
CTTGTAACTAA -> TTGTAACTAAT
GTTAGGCTGGC -> TTAGGCTGGCA
GGCAATTCTTA -> GCAATTCTTAT
AATTAGCAGGA -> ATTAGCAGGAG
CATCGACGGCT -> ATCGACGGCTT
TCCATGATTAC -> CCATGATTACC
TCCGTAGAACC -> CCGTAGAACCT
AGTAACTCCGA -> GTAACTCCGAA
AATTTAATTGC -> ATTTAATTGCC
CAAGGAGTCAC -> AAGGAGTCACA
TGGCCTTGCTT -> GGCCTTGCTTG
CCGTGAAGAAA -> CGTGAAGAAAT
TTACGGACAAC -> TACGGACAACT
TGCCCGCGTAC -> GCCCGCGTACC
ACATGTTTGCT -> CATGTTTGCTA
CTGACGCCCCC -> TGACGCCCCCA
GAGTCTGATAT -> AGTCTGATATG
AATTACGACGA -> ATTACGACGAG
ATCTTTGGACC -> TCTTTGGACCC
GTAAAGGCTGC -> TAAAGGCTGCG
ATCTGTGAAAC -> TCTGTGAAACG
CTTAATTTATG -> TTAATTTATGG
TGCGAGGAAAC -> GCGAGGAAACT
GACGAGACGTT -> ACGAGACGTTA
CTTCCCCTAAG -> TTCCCCTAAGG
TATGTTTACAC -> ATGTTTACACC
CTTGTTATAAT -> TTGTTATAATT
GGACGGGAAGG -> GACGGGAAGGT
GGTCTTCTGTG -> GTCTTCTGTGT
CTCGGACTCTA -> TCGGACTCTAT
CACGACCCTCT -> ACGACCCTCTA
CTATGTATGTA -> TATGTATGTAG
GGGACGGGAAG -> GGACGGGAAGG
CTACCAGCTTT -> TACCAGCTTTC
AAGTAAAGGCT -> AGTAAAGGCTG
TATAAACCATA -> ATAAACCATAT
GTGCGCTTGTC -> TGCGCTTGTCG
CAAACATTTCA -> AAACATTTCAG
GTTCCTATCTT -> TTCCTATCTTT
ACTGGAATGCG -> CTGGAATGCGA
TGTTATTAAGC -> GTTATTAAGCG
TCTTACAGGAT -> CTTACAGGATG
TGTAGACCCAT -> GTAGACCCATG
TATGTAGGAAG -> ATGTAGGAAGC
CTGAGGGGGTT -> TGAGGGGGTTT
GTAGGTTCTAA -> TAGGTTCTAAG
CACCATAACCG -> ACCATAACCGA
TGTAGATTCGG -> GTAGATTCGGC
TAGTTGGTAGT -> AGTTGGTAGTT
AGGGGAGCCTC -> GGGGAGCCTCT
TAGCTAAGCCG -> AGCTAAGCCGT
TGGAGGCGATA -> GGAGGCGATAA
GGATCAGAGAA -> GATCAGAGAAC
CGCGTGTTTAA -> GCGTGTTTAAT
ATTATGCACCA -> TTATGCACCAT
AACATTGGACG -> ACATTGGACGA
CCGCGGCCGAG -> CGCGGCCGAGT
ACGAGACGTTA -> CGAGACGTTAG
CGTACAAGGAG -> GTACAAGGAGT
CTTAAGTGTAG -> TTAAGTGTAGA
TGAAACGCAGA -> GAAACGCAGAA
GGAGACTTTAC -> GAGACTTTACG
TGCGACGAATA -> GCGACGAATAC
CAAGGCTTAGT -> AAGGCTTAGTA
GGAGACCGCAG -> GAGACCGCAGA
GTAAGGAAGTA -> TAAGGAAGTAA
CCAACCATTCT -> CAACCATTCTC
GCCTTGCTTGA -> CCTTGCTTGAC
CCCGTGGCACA -> CCGTGGCACAA
TATATCGGGGA -> ATATCGGGGAC
ACACCGCAGGC -> CACCGCAGGCG
TGAGGGGGTTT -> GAGGGGGTTTT
AGTGTAGATTC -> GTGTAGATTCG
GCCTTGTAACT -> CCTTGTAACTA
GCAGAACGACA -> CAGAACGACAC
CGCGTTCCTGA -> GCGTTCCTGAC
CCGTAAATTAT -> CGTAAATTATA
ATACTGCGCAC -> TACTGCGCACT
GCAACCATCCA -> CAACCATCCAT
CATGTGGGGAC -> ATGTGGGGACG
TGATAGGGGAG -> GATAGGGGAGT
GTGGATCAGAG -> TGGATCAGAGA
AAAACTTACTA -> AAACTTACTAA
TACTAAACTTA -> ACTAAACTTAG
TGTACCGCGGC -> GTACCGCGGCC
CGGGTGGTACA -> GGGTGGTACAT
GGGGCTGACGG -> GGGCTGACGGC
GGCGGGTTCTT -> GCGGGTTCTTA
TGGGGTTATGG -> GGGGTTATGGG
GATGATGAAGC -> ATGATGAAGCT
CGAACTACTAC -> GAACTACTACC
CGCAGCTGGGT -> GCAGCTGGGTA
CACTTAATGCA -> ACTTAATGCAC
CCATAATACGC -> CATAATACGCA
GTGAAGAAATG -> TGAAGAAATGC
TGATCGACGTC -> GATCGACGTCT
TGCTCGTGGGG -> GCTCGTGGGGG
CGTGCATGGTC -> GTGCATGGTCT
CACAATCAGCC -> ACAATCAGCCT
GCTGATAGGGG -> CTGATAGGGGA
GAGGAAACTCT -> AGGAAACTCTC
GTGGCAATATT -> TGGCAATATTT
GACGCCCCCAC -> ACGCCCCCACC
CGGCCACCCAG -> GGCCACCCAGG
GCGTTTTAGGG -> CGTTTTAGGGG
CGTTCCTGACG -> GTTCCTGACGC
GTCTGGTGCAT -> TCTGGTGCATA
GCGCGTGTTTA -> CGCGTGTTTAA
CTCCGAACTGG -> TCCGAACTGGC
AAACGCAGGGG -> AACGCAGGGGC
TTTGGACCCGA -> TTGGACCCGAG
CCTTTCCAAGA -> CTTTCCAAGAC
CAAGAATTGTT -> AAGAATTGTTA
TGGCGGGTTCT -> GGCGGGTTCTT
TATGGGGTCCT -> ATGGGGTCCTT
GTAGTTATTAG -> TAGTTATTAGC
ACTTTACGGGT -> CTTTACGGGTA
TCGTTATACTG -> CGTTATACTGG
TAGAGTCTGAT -> AGAGTCTGATA
GACAAACACTT -> ACAAACACTTC
TAGCAGGAGAC -> AGCAGGAGACT
AATAACATTGG -> ATAACATTGGA
GACGGCCTTAC -> ACGGCCTTACA
TCCACACTTAA -> CCACACTTAAT
AGGAAGCTTGT -> GGAAGCTTGTC
CTGCGCACTCG -> TGCGCACTCGA
AGTATCGATGA -> GTATCGATGAT
CGAGGTTATCG -> GAGGTTATCGT
ATACTAGGATA -> TACTAGGATAT
GTAACTAATAA -> TAACTAATAAA
GTAGAGAGGCA -> TAGAGAGGCAA
TTGTTTGCTCG -> TGTTTGCTCGG
CGACGATTACG -> GACGATTACGA
ACTGTTAGCAG -> CTGTTAGCAGA
GGAGAAGTTAC -> GAGAAGTTACG
CCCCACCGCGT -> CCCACCGCGTT
AGTTACGGACA -> GTTACGGACAA
CGCCTAGGGCC -> GCCTAGGGCCG
GGAGTGCAGCT -> GAGTGCAGCTA
ATTGTTAATCC -> TTGTTAATCCG
ATTACCGAAAA -> TTACCGAAAAC
ATATTGTTTGC -> TATTGTTTGCT
CAGCGACAGCA -> AGCGACAGCAT
TACTACCATCT -> ACTACCATCTG
CGGGTTCTTAC -> GGGTTCTTACA
TGGTCTGAAGC -> GGTCTGAAGCG
TATAGTGGGAG -> ATAGTGGGAGA
TCTAAGCTGAT -> CTAAGCTGATA
ACTAGGATATC -> CTAGGATATCA
TACCAGCTTTC -> ACCAGCTTTCA
GCCGAGTCGCA -> CCGAGTCGCAA
AAGGGGAGCCT -> AGGGGAGCCTC
CCTCCCAAGCG -> CTCCCAAGCGC
TAGTGGGAGAA -> AGTGGGAGAAG
ACGGACAACTT -> CGGACAACTTT
CTAGTTGGTAG -> TAGTTGGTAGT
AAATCAAGCCG -> AATCAAGCCGG
GAGAACTTAAC -> AGAACTTAACC
ACCATCTGTGA -> CCATCTGTGAA
CGCATCAGTAA -> GCATCAGTAAG
TTCTGTGTACC -> TCTGTGTACCG
CGCGTACCTCC -> GCGTACCTCCC
GAAGCTTGTCG -> AAGCTTGTCGG
TTTCGTAGGAC -> TTCGTAGGACC
GAAGTAAAGGC -> AAGTAAAGGCT
ATCGCTCAAAT -> TCGCTCAAATC
GCAGGCGAGCA -> CAGGCGAGCAG
CTTACAGGATG -> TTACAGGATGA
TTACGTGCGCT -> TACGTGCGCTT
CCGCAGGCGAG -> CGCAGGCGAGC
TAACCATAATA -> AACCATAATAC
TTGACTCGATT -> TGACTCGATTA
TCATGTAGCGG -> CATGTAGCGGT
GCTGGCAGTCA -> CTGGCAGTCAA
TTGGCAAGGCT -> TGGCAAGGCTT
GACGTTAGGCT -> ACGTTAGGCTG
GGGAAGCAGAA -> GGAAGCAGAAT
TCCGAACTGGC -> CCGAACTGGCC
CGGACAACTTT -> GGACAACTTTC
TCAGTATTGCG -> CAGTATTGCGA
ACGTCCGTTTC -> CGTCCGTTTCG
TAGCGGTACGG -> AGCGGTACGGA
GTAAGGTATAA -> TAAGGTATAAC
CGTTCCAACCA -> GTTCCAACCAT
CGGGCTATATA -> GGGCTATATAT
GTACACATCTC -> TACACATCTCG
GAGGCGATAAC -> AGGCGATAACC
CTAACTACTAC -> TAACTACTACC
TGCGCACTCGA -> GCGCACTCGAA
CCGGCTAGCAT -> CGGCTAGCATA
GCAGTGTTATT -> CAGTGTTATTA
TTCTAAGGACA -> TCTAAGGACAT
CAGGAGACTTT -> AGGAGACTTTA
GGTCTAGGGTG -> GTCTAGGGTGG
CTGCATCGACG -> TGCATCGACGG
CGACAGCATGC -> GACAGCATGCT
GCTGGGTACTC -> CTGGGTACTCC
TGTCGGGGAGT -> GTCGGGGAGTC
GGATTACCAAA -> GATTACCAAAC
TAACATGGGGT -> AACATGGGGTT
TGCCTTTGGGA -> GCCTTTGGGAA
CTCGGAACTTA -> TCGGAACTTAC
AGCCCGAGGCG -> GCCCGAGGCGG
GGCGATAACCT -> GCGATAACCTA
TAGACCCATGC -> AGACCCATGCT
CGCAAGTGGAT -> GCAAGTGGATC
GCTAAGTCGGG -> CTAAGTCGGGC
CAGTGGCATTT -> AGTGGCATTTC
GACCCATGCTC -> ACCCATGCTCC
ATCCGTAGAAC -> TCCGTAGAACC
TAGGGGAGTGC -> AGGGGAGTGCA
CGATGATGAAG -> GATGATGAAGC
TGGCCATAATC -> GGCCATAATCC
GGCTAGCATAA -> GCTAGCATAAG
TCGGAACTTAC -> CGGAACTTACG
TCGTCCGGCCT -> CGTCCGGCCTG
ATTATAGGTAA -> TTATAGGTAAG
TACGCTACATG -> ACGCTACATGT
AGCCTTAACTG -> GCCTTAACTGA
TGGCATTTCAT -> GGCATTTCATA
GCCTTACACGA -> CCTTACACGAC
TTCGCCTTGTA -> TCGCCTTGTAA
GTCTTCTGTGT -> TCTTCTGTGTA
GTACCGCGGCC -> TACCGCGGCCG
AGCCGGGAAGT -> GCCGGGAAGTA
TCTTCCCCTAA -> CTTCCCCTAAG
CCACGTCCGTT -> CACGTCCGTTT
GCAATTCTTAT -> CAATTCTTATA
GCTTAATTTAT -> CTTAATTTATG
GGGAGTCGTCG -> GGAGTCGTCGA
ACAGCATGCTG -> CAGCATGCTGC
ACGCATCAGTA -> CGCATCAGTAA
GCGGTACGGAC -> CGGTACGGACG
ATCCCCATACT -> TCCCCATACTG
TAGGTAAGGAA -> AGGTAAGGAAG
CCGTGCATGGT -> CGTGCATGGTC
AACCCTGAGGG -> ACCCTGAGGGG
GCGAGGAAACT -> CGAGGAAACTC
TATTCCGCCTA -> ATTCCGCCTAG
CAATACGCCGA -> AATACGCCGAT
ATTGGAGACCG -> TTGGAGACCGC
AATACAGCGAC -> ATACAGCGACA
AAGTATCGATG -> AGTATCGATGA
AAGCTGATAGG -> AGCTGATAGGG
GAAGTAGGTTC -> AAGTAGGTTCT
GGTACATATGT -> GTACATATGTG
AGCAGAATAAG -> GCAGAATAAGA
GATTCGGCAGA -> ATTCGGCAGAA
CTGCTGTAGGT -> TGCTGTAGGTA
GGAGGCGATAA -> GAGGCGATAAC
GATGTAGACCC -> ATGTAGACCCA
CCATGCTCCTC -> CATGCTCCTCC
GTTATTAAGCG -> TTATTAAGCGG
GGGGAAGCAGA -> GGGAAGCAGAA
TTAAGTGTAGA -> TAAGTGTAGAT
TCCAACCATTC -> CCAACCATTCT
TTACGATACTA -> TACGATACTAG
CGAGCAGTGTT -> GAGCAGTGTTA
TCTCAATACGC -> CTCAATACGCC
CAGCGCGTTCC -> AGCGCGTTCCT
AAACCCACACT -> AACCCACACTC
TAGGAAGCTTG -> AGGAAGCTTGT
ATTTCATAATT -> TTTCATAATTG
CAAATCCTACC -> AAATCCTACCC
TACACCGCAGG -> ACACCGCAGGC
GGGGATACTGG -> GGGATACTGGC
CGTGTTTAATA -> GTGTTTAATAC
AACAATAATTA -> ACAATAATTAG
TACCATCTGTG -> ACCATCTGTGA
CTGAAGCGCTG -> TGAAGCGCTGC
AAGCTTGTCGG -> AGCTTGTCGGG
CTAGGATATCA -> TAGGATATCAT
GCCACCCAGGC -> CCACCCAGGCT
AATAAGATTTA -> ATAAGATTTAA
GAAGACAAGCT -> AAGACAAGCTG
CCGTGGCACAA -> CGTGGCACAAT
AACGCAGAAAA -> ACGCAGAAAAC
GTCAATACTCA -> TCAATACTCAA
ATGAGTACGCT -> TGAGTACGCTA
TCAAACGCAGG -> CAAACGCAGGG
GGTAGTTATTA -> GTAGTTATTAG
GTGGCATTTCA -> TGGCATTTCAT
CTTTCGTAGGA -> TTTCGTAGGAC
CCCATGCTCCT -> CCATGCTCCTC
TATCGCAAACC -> ATCGCAAACCC
GCTTAGACAAA -> CTTAGACAAAA
TTAATTTATGG -> TAATTTATGGG
GGGCTATATAT -> GGCTATATATC
GCCGGGCTTAG -> CCGGGCTTAGA
CGATAACCTAG -> GATAACCTAGT
CTTTCCAAGAC -> TTTCCAAGACC
CGAATACTGCG -> GAATACTGCGC
GCCTGCTCGTG -> CCTGCTCGTGG
ATACTGGATTA -> TACTGGATTAC
GGCGCTTAATT -> GCGCTTAATTT
TGGTAGTTATT -> GGTAGTTATTA
TTCAATAACAT -> TCAATAACATT
TCCAAGACCGG -> CCAAGACCGGG
ATACTGTTAGC -> TACTGTTAGCA
CATTCTCTGGA -> ATTCTCTGGAG
TCGTCTCAAGT -> CGTCTCAAGTG
GTTGCCCGCGT -> TTGCCCGCGTA
ATGGTCTGAAG -> TGGTCTGAAGC
CTCTGTGACGA -> TCTGTGACGAC
ACGCAGGGGCG -> CGCAGGGGCGC
GCAACCCTGAG -> CAACCCTGAGG
CCAGCTGCGTC -> CAGCTGCGTCC
GTGCATAATTA -> TGCATAATTAC
AAGCGCGACCA -> AGCGCGACCAA
TTCCCGAGCAC -> TCCCGAGCACC
ATGTGCATAAT -> TGTGCATAATT
TTACTAAACTT -> TACTAAACTTA
CATCCATTGAA -> ATCCATTGAAG
GCTATATATCG -> CTATATATCGG
GAGGCGGGTGG -> AGGCGGGTGGT
CCCGAGCACCA -> CCGAGCACCAG
ACGGTCTCATC -> CGGTCTCATCT
GAACCTCTGTG -> AACCTCTGTGA
CTCCATACGGT -> TCCATACGGTC
TTGTAACTAAT -> TGTAACTAATA
GACACCAGCTG -> ACACCAGCTGC
GTCTGATATGC -> TCTGATATGCA
ACTACCATCTG -> CTACCATCTGT
CAATCAGCCTT -> AATCAGCCTTA
CGGTACGGACG -> GGTACGGACGC
ACTTACGTGCG -> CTTACGTGCGC
CCATACTGTTA -> CATACTGTTAG
CCTTAAGTGTA -> CTTAAGTGTAG
AGCCTCTCTCG -> GCCTCTCTCGT
GACAACTTTCC -> ACAACTTTCCC
AGACAAGCTGC -> GACAAGCTGCC
CAATAATTAGC -> AATAATTAGCA
GAAGCAGCGCG -> AAGCAGCGCGT
GGACTGGAATG -> GACTGGAATGC
CCATCTGTGAA -> CATCTGTGAAA
CTCATGTAGCG -> TCATGTAGCGG
ATCAGCCTTAA -> TCAGCCTTAAC
TTGGGAAAACT -> TGGGAAAACTC
AAGACGCGATC -> AGACGCGATCG
TATAATTAACA -> ATAATTAACAT
TAGGTGACCTT -> AGGTGACCTTG
AAGGCTTAGTA -> AGGCTTAGTAA
ATACAGCGACA -> TACAGCGACAG
TGCACCATAAC -> GCACCATAACC
CTCTTCCCCTA -> TCTTCCCCTAA
CGACGAGACGT -> GACGAGACGTT
CCTCGGACTCT -> CTCGGACTCTA
CCCGAGGCGGG -> CCGAGGCGGGT
GGACCCCCTCT -> GACCCCCTCTC
CGTGACCCGTG -> GTGACCCGTGG
TTAGCTAAGCC -> TAGCTAAGCCG
ATCAGAAGTAG -> TCAGAAGTAGG
GAACGACACGC -> AACGACACGCG
CTTCAGCCTCT -> TTCAGCCTCTC
GGTACTCCAGC -> GTACTCCAGCA
CCATCAATGTA -> CATCAATGTAT
ATTTAACCACG -> TTTAACCACGT
CCTCCATACGG -> CTCCATACGGT
ACTAAACTTAG -> CTAAACTTAGG
ATAATTAACAT -> TAATTAACATG
CTATGGGAGAT -> TATGGGAGATG
AGCGACAGCAT -> GCGACAGCATG
AAACATTTCAG -> AACATTTCAGC
GACACGCGCGT -> ACACGCGCGTG
TAATCCACACT -> AATCCACACTT
GACAGCATGCT -> ACAGCATGCTG
AGAGTCTGATA -> GAGTCTGATAT
CGATTGGTAAG -> GATTGGTAAGC
GGCGAGCAGTG -> GCGAGCAGTGT
GGGGTCCTTGA -> GGGTCCTTGAA
GCCTTTGGGAA -> CCTTTGGGAAA
TGCTTGACCAT -> GCTTGACCATT
GACCGTAAATT -> ACCGTAAATTA
CTGGATTACCA -> TGGATTACCAA
CATAATACGCA -> ATAATACGCAT
GGCAGTCAATA -> GCAGTCAATAC
AGTGGATCAGA -> GTGGATCAGAG
AGACCGTAAAT -> GACCGTAAATT
TAGCAGAACGA -> AGCAGAACGAC
CTACATGTTTG -> TACATGTTTGC
GTTGGTCCATG -> TTGGTCCATGA
GAATCGTTATA -> AATCGTTATAC
AGCAGAACGAC -> GCAGAACGACA
GCGCAAGTGGA -> CGCAAGTGGAT
ATAAACCTCCA -> TAAACCTCCAG
GACCAGTGGCA -> ACCAGTGGCAT
TACCAAACCAT -> ACCAAACCATG
TCTAGAGTCTG -> CTAGAGTCTGA
TCTCTCGTCCG -> CTCTCGTCCGG
GCTCACTTTCG -> CTCACTTTCGT
CGGGAAGGTCT -> GGGAAGGTCTA
CCGCGTTCCAA -> CGCGTTCCAAC
CAACTTTCCCG -> AACTTTCCCGA
GGTTCCTATCT -> GTTCCTATCTT
AGCTACCGGGT -> GCTACCGGGTC
TCTTATAGTGG -> CTTATAGTGGG
TGGCAAGGCTT -> GGCAAGGCTTA
GTTTGCTATGG -> TTTGCTATGGG
TATATATCGGG -> ATATATCGGGG
TTCCTATCTTT -> TCCTATCTTTG
AGGGGCTGACG -> GGGGCTGACGG
ACTCCGAACTG -> CTCCGAACTGG
CCATAACCGAA -> CATAACCGAAC
GAGCCCGAGGC -> AGCCCGAGGCG
GGCGGGTGGTA -> GCGGGTGGTAC
AACTTAGGTGA -> ACTTAGGTGAC
TTACGGGTACC -> TACGGGTACCC
TAAGTGTAGAT -> AAGTGTAGATT
CTACCATCTGT -> TACCATCTGTG
AGCTAAGTCGG -> GCTAAGTCGGG
GGTTATCGTCT -> GTTATCGTCTC
CCTCTCTCGTC -> CTCTCTCGTCC
TAAATGACAAA -> AAATGACAAAC
ACGGGTTCCTA -> CGGGTTCCTAT
CCGTAGAACCT -> CGTAGAACCTC
AATTATAGGTA -> ATTATAGGTAA
ACTTAATGCAC -> CTTAATGCACA
CTCAAACGCAG -> TCAAACGCAGG
CCAAGCGCGAC -> CAAGCGCGACC
CGAATCGTTAT -> GAATCGTTATA
AATATTTCTGT -> ATATTTCTGTA
GCCTCTCTCGT -> CCTCTCTCGTC
ATATGTGCATA -> TATGTGCATAA
CCAGCAACCCT -> CAGCAACCCTG
CCATATTGTTT -> CATATTGTTTG
ATCAATGTATA -> TCAATGTATAC
TTTGCTAACTA -> TTGCTAACTAC
AAACCTCCAGC -> AACCTCCAGCA
TCTGATATGCA -> CTGATATGCAG
GGCAGACCGTA -> GCAGACCGTAA
ACCCTTAAGTG -> CCCTTAAGTGT
AAATGCAAGCT -> AATGCAAGCTG
ATCGACGTCTA -> TCGACGTCTAG
ACATCTCGTGA -> CATCTCGTGAC
TTCCCCTAAGG -> TCCCCTAAGGC
CGGGCTTAGAC -> GGGCTTAGACA
GACATGTGGGG -> ACATGTGGGGA
TGGGTACTCCA -> GGGTACTCCAG
CGTAGGACCCC -> GTAGGACCCCC
GAAGGTCTAGG -> AAGGTCTAGGG
CAAGACCGGGG -> AAGACCGGGGC
GGTCTGAAGCG -> GTCTGAAGCGC
CTTTGGACCCG -> TTTGGACCCGA
TCGCTCAAATC -> CGCTCAAATCC
CAAGCGCGACC -> AAGCGCGACCA
ATTAAGCGGGG -> TTAAGCGGGGG
GTCACAAGACG -> TCACAAGACGC
CGAGGCGGGTG -> GAGGCGGGTGG
AATTGAGCTAT -> ATTGAGCTATA
TCATAATTGAG -> CATAATTGAGC
TCTGTGAAACG -> CTGTGAAACGC
GAAAACTTACT -> AAAACTTACTA
AGCAGTGTTAT -> GCAGTGTTATT
CGGGGACCCCT -> GGGGACCCCTG
ACTTTCCCGAG -> CTTTCCCGAGC
TCGGGGAGTCG -> CGGGGAGTCGT
GCGGGGGAAGC -> CGGGGGAAGCA
GGTACACATCT -> GTACACATCTC
AACCCACACTC -> ACCCACACTCG
AGGGTGGCAAT -> GGGTGGCAATA
CGACCAGTGGC -> GACCAGTGGCA
ACAAGACGCGA -> CAAGACGCGAT
ACACTCGACAC -> CACTCGACACC
CACACTCGACA -> ACACTCGACAC
GGCTTTTGCTA -> GCTTTTGCTAA
TGGTGCATAAA -> GGTGCATAAAC
CTTACGTGCGC -> TTACGTGCGCT
GAAAACAATAA -> AAAACAATAAT
TTTCGCCTTGT -> TTCGCCTTGTA
TGTTAATCCGT -> GTTAATCCGTA
CACGCGCGTGT -> ACGCGCGTGTT
CGATTACGATA -> GATTACGATAC
AGCGCGTTCCT -> GCGCGTTCCTG
GGTCTCATCTG -> GTCTCATCTGG
CAAGACGCGAT -> AAGACGCGATC
TGCAGCTACCG -> GCAGCTACCGG
AGCAGCGCGTT -> GCAGCGCGTTC
GATTATGCACC -> ATTATGCACCA
ATCAGTAAGGT -> TCAGTAAGGTA
ACGCGATCGCT -> CGCGATCGCTC
CATAATTGAGC -> ATAATTGAGCT
GACGATTACGA -> ACGATTACGAT
GCCCACCACGG -> CCCACCACGGG
TCCGACGATTA -> CCGACGATTAC
TCTTCTGTGTA -> CTTCTGTGTAC
TGCTAACTACT -> GCTAACTACTA
TCACAAGACGC -> CACAAGACGCG
AGGTATAACGC -> GGTATAACGCC
CGGGACTGGAA -> GGGACTGGAAT
CTTATAGTGGG -> TTATAGTGGGA
CATGGTCTGAA -> ATGGTCTGAAG
CGATTGGAGAC -> GATTGGAGACC
TGGGAGATGTA -> GGGAGATGTAG
CCACCACGGGA -> CACCACGGGAC
ATTTCTGTACA -> TTTCTGTACAG
TGAGCTATACC -> GAGCTATACCG
CTCCTCCATAC -> TCCTCCATACG
GCGCTGCATCG -> CGCTGCATCGA
TCGACGTCTAG -> CGACGTCTAGA
TGATGCCGTAG -> GATGCCGTAGC
GCCTAGGGCCG -> CCTAGGGCCGG
CTAAGGACATG -> TAAGGACATGT
TACTACCAGCT -> ACTACCAGCTT
GTGACCTTGGC -> TGACCTTGGCA
CATTTCAGCCG -> ATTTCAGCCGG
ATACTAGACGG -> TACTAGACGGG
CTGCGTCCCTT -> TGCGTCCCTTG
TAGCGCAAGTG -> AGCGCAAGTGG
ATGCTCCTCCA -> TGCTCCTCCAT
ATATTTCTGTA -> TATTTCTGTAC
TATCTTTGGAC -> ATCTTTGGACC
TAAACCTCCAG -> AAACCTCCAGC
CAAACGCAGGG -> AAACGCAGGGG
TATACCGTGCA -> ATACCGTGCAT
AAAGTCTGGTG -> AAGTCTGGTGC
CGGCTAGCATA -> GGCTAGCATAA
TGTATGTAGGA -> GTATGTAGGAA
ATGGGGTTATG -> TGGGGTTATGG
ACGATACTAGA -> CGATACTAGAC
AACCATCCATT -> ACCATCCATTG
GACGCAGCTGG -> ACGCAGCTGGG
AGACAAAAGCC -> GACAAAAGCCC
ACCCACACTCG -> CCCACACTCGA
CGTTTTAGGGG -> GTTTTAGGGGC
CGGAACTTACG -> GGAACTTACGT
ATGGGGTCCTT -> TGGGGTCCTTG
CAGAAGTAGGT -> AGAAGTAGGTT
GATTTAACCAC -> ATTTAACCACG
GGGTTATGGGG -> GGTTATGGGGT
CGTTATACTGG -> GTTATACTGGA
ACAATAATTAG -> CAATAATTAGC
TACCCTTAAGT -> ACCCTTAAGTG
TTCGTAGGACC -> TCGTAGGACCC
AGACCCATGCT -> GACCCATGCTC
TAATTGAGCTA -> AATTGAGCTAT
CTGGTGCATAA -> TGGTGCATAAA
TTGCTAACTAC -> TGCTAACTACT
CGAGCCCGAGG -> GAGCCCGAGGC
ATGTAGCGGTA -> TGTAGCGGTAC
ATACTCAAACG -> TACTCAAACGC
TGCGTTTTAGG -> GCGTTTTAGGG
CTATCTGGCCA -> TATCTGGCCAT
GTTCCAACCAT -> TTCCAACCATT
GCGATCGCTCA -> CGATCGCTCAA
GAGTCGCAACC -> AGTCGCAACCA
CCAGTGGCATT -> CAGTGGCATTT
TGAAATCAAGC -> GAAATCAAGCC
CAGCTACCGGG -> AGCTACCGGGT
GGTTCTAAGGA -> GTTCTAAGGAC
CGGAGGCTCCC -> GGAGGCTCCCT
CACATTAGCGC -> ACATTAGCGCA
AACCACGTCCG -> ACCACGTCCGT
GGGGCGAGCCC -> GGGCGAGCCCG
GACCGCAGACC -> ACCGCAGACCT
ACCGGGTCCCC -> CCGGGTCCCCA
AGAAAACTTAC -> GAAAACTTACT
TTCCAAGACCG -> TCCAAGACCGG
CATCTGGACTA -> ATCTGGACTAA
TAGGTTCTAAG -> AGGTTCTAAGG
CTCTCGTCTCA -> TCTCGTCTCAT
TTAATGCACAT -> TAATGCACATT
ACGTGCGCTTG -> CGTGCGCTTGT
TGAAGCTATGT -> GAAGCTATGTA
TCTGAAGCGCT -> CTGAAGCGCTG
GCGAGCAGTGT -> CGAGCAGTGTT
GTATCGATGAT -> TATCGATGATG
GCGTACCTCCC -> CGTACCTCCCA
AGCTATGTATG -> GCTATGTATGT
ATAATTAGCAG -> TAATTAGCAGG
CGATCGCTCAA -> GATCGCTCAAA
AACTACTACCA -> ACTACTACCAT,ACTACTACCAG
TCGTCTCATGT -> CGTCTCATGTA
GCAATATTTCT -> CAATATTTCTG
GTCAGTATTGC -> TCAGTATTGCG
CTCGTCTCATG -> TCGTCTCATGT
ATCCGACGATT -> TCCGACGATTA
ATTAACATGGG -> TTAACATGGGG
GGGGGAAGCAG -> GGGGAAGCAGA
CACCAGGGGCT -> ACCAGGGGCTG
ACTTAGGTGAC -> CTTAGGTGACC
CCGCGTACCTC -> CGCGTACCTCC
CTAAGTCGGGC -> TAAGTCGGGCT
GGGGGATACTG -> GGGGATACTGG
CACCCAGGCTC -> ACCCAGGCTCA
CCAGGGGCTGA -> CAGGGGCTGAC
GTCGGGCTATA -> TCGGGCTATAT
ACCACGGGACT -> CCACGGGACTG
AGCGGGGGAAG -> GCGGGGGAAGC
CGGGGGAAGCA -> GGGGGAAGCAG
TGTATTCCGCC -> GTATTCCGCCT
CCATGATCGAC -> CATGATCGACG
CTATGTTTACA -> TATGTTTACAC
CCGTTGCCCGC -> CGTTGCCCGCG
TTTACACCGCA -> TTACACCGCAG
TCGTGACCCGT -> CGTGACCCGTG
GTTATAATTAA -> TTATAATTAAC
TTTATGGGTCT -> TTATGGGTCTT
TCCTTGAAATC -> CCTTGAAATCA
CGAAAACAATA -> GAAAACAATAA
GCCTCTCGGAA -> CCTCTCGGAAC
TAAGTCGGGCT -> AAGTCGGGCTA
ACCATTCTCTG -> CCATTCTCTGG
CCCTTTCCAAG -> CCTTTCCAAGA
TCTCATGTAGC -> CTCATGTAGCG
GACTCGATTAT -> ACTCGATTATG
GGACCCGAGGT -> GACCCGAGGTT
CAATAACATTG -> AATAACATTGG
ATTGGACGATT -> TTGGACGATTC
GCGCGACCAAT -> CGCGACCAATC
GTACCTCCCAA -> TACCTCCCAAG
ACGTTAGGCTG -> CGTTAGGCTGG
TGTATACTAGG -> GTATACTAGGA
GCAGGAGACTT -> CAGGAGACTTT
ATAACGCCCAG -> TAACGCCCAGG
TAACCGAACTA -> AACCGAACTAC
GTAAGCTAAGT -> TAAGCTAAGTC
GATGCCGTAGC -> ATGCCGTAGCG
TATTAAGCGGG -> ATTAAGCGGGG
TCGGAGGCTCC -> CGGAGGCTCCC
CACAAGACGCG -> ACAAGACGCGA
AACCTCTGTGA -> ACCTCTGTGAC
ATAATTACGAC -> TAATTACGACG
TACTCAAACGC -> ACTCAAACGCA
ATCGACGGCTT -> TCGACGGCTTT
ATGATCGACGT -> TGATCGACGTC
ACGATTCTCAA -> CGATTCTCAAT
GAGATGTAGAC -> AGATGTAGACC
CCGGGAAGTAT -> CGGGAAGTATC
TGTGACGACCA -> GTGACGACCAG
AAGCCCACCAC -> AGCCCACCACG
GTCCTTGAAAT -> TCCTTGAAATC
GTCGTACAAGG -> TCGTACAAGGA
AGTCTGGTGCA -> GTCTGGTGCAT
CAGGTTCCGTT -> AGGTTCCGTTG
TCTGTGACGAC -> CTGTGACGACC
TGGTCCATGAT -> GGTCCATGATT
CACTTTCGTAG -> ACTTTCGTAGG
CTGACGGCCTT -> TGACGGCCTTA
GTGTACCGCGG -> TGTACCGCGGC
TGATGAAGCTA -> GATGAAGCTAT
GACCATTATTA -> ACCATTATTAA
GGGTGGTACAT -> GGTGGTACATA
ACCTCTGTGAC -> CCTCTGTGACG
CGGGTCCCCAT -> GGGTCCCCATC
CAGCCTTAACT -> AGCCTTAACTG
CCGGCCACCCA -> CGGCCACCCAG
AGCGCAAGTGG -> GCGCAAGTGGA
TCAATACTCAA -> CAATACTCAAA
CGCAGGCGAGC -> GCAGGCGAGCA
ATAGTGGGAGA -> TAGTGGGAGAA
GCACCAGGGGC -> CACCAGGGGCT
GCAGACCTGCT -> CAGACCTGCTG
GTTATTAGCTA -> TTATTAGCTAA
CTTTACGGGTA -> TTTACGGGTAC
TAGGACCCCCT -> AGGACCCCCTC
CCTCTCGGAAC -> CTCTCGGAACT
ATCGGGGACCC -> TCGGGGACCCC
TACCGTGCATG -> ACCGTGCATGG
GCTCGTGGGGG -> CTCGTGGGGGA
GTCCGGCCTGC -> TCCGGCCTGCT
GCGACCAATCC -> CGACCAATCCG
GCTTTCAATAA -> CTTTCAATAAC
CCTGAGGGGGT -> CTGAGGGGGTT
TACTGTTAGCA -> ACTGTTAGCAG
TAACTGAAATT -> AACTGAAATTT
ACCGCAGACCT -> CCGCAGACCTG
TCCTCCATACG -> CCTCCATACGG
CTCGTGACCCG -> TCGTGACCCGT
TCTTTGGACCC -> CTTTGGACCCG
TGTTGGTCCAT -> GTTGGTCCATG
AGGCTGGCAGT -> GGCTGGCAGTC
ACAGCGACAGC -> CAGCGACAGCA
GACGATTCTCA -> ACGATTCTCAA
CCAGGCTCACT -> CAGGCTCACTT
TCCTACCCTTT -> CCTACCCTTTC
GCCGGCCACCC -> CCGGCCACCCA
GAGAAGTTACG -> AGAAGTTACGG
CAGACCGTAAA -> AGACCGTAAAT
TTTAACCACGT -> TTAACCACGTC
CTTAATGCACA -> TTAATGCACAT
CAGGGGCTGAC -> AGGGGCTGACG
CCTTTGGGAAA -> CTTTGGGAAAA
GTAGGTAGAGA -> TAGGTAGAGAG
ACCAAACCATG -> CCAAACCATGA
GCTAGCATAAG -> CTAGCATAAGG
TCTGTGTACCG -> CTGTGTACCGC
CTAGACGGGTT -> TAGACGGGTTC
CATAAGGATCA -> ATAAGGATCAG
TTAGCAGGAGA -> TAGCAGGAGAC
GGGGTTATGGG -> GGGTTATGGGG
GCCGGCTAGCA -> CCGGCTAGCAT
GCAGAAAACTT -> CAGAAAACTTA
AACCATGATCG -> ACCATGATCGA
GACCGGGGCGA -> ACCGGGGCGAG
TACGGACAACT -> ACGGACAACTT
TGCCGGGCTTA -> GCCGGGCTTAG
GCTACCGGGTC -> CTACCGGGTCC
GTCTAGGGTGG -> TCTAGGGTGGC
AGCGCGACCAA -> GCGCGACCAAT
GCTGCGGTACA -> CTGCGGTACAC
ATGGGAGATGT -> TGGGAGATGTA
ACACGCGCGTG -> CACGCGCGTGT
TCGTACAAGGA -> CGTACAAGGAG
GAATACTGCGC -> AATACTGCGCA
TCAGTAAGGTA -> CAGTAAGGTAT
TCGACACCAGC -> CGACACCAGCT
GGTTATGGGGT -> GTTATGGGGTC
TGCATAAACCT -> GCATAAACCTC
GATCAGAAGTA -> ATCAGAAGTAG
CCATAATCCAC -> CATAATCCACA
GGGGACGGGAA -> GGGACGGGAAG
GTATGTAGGAA -> TATGTAGGAAG
ACCATCCATTG -> CCATCCATTGA
CGGTCTCATCT -> GGTCTCATCTG
CTTAGGTGACC -> TTAGGTGACCT
CCTATCTTTGG -> CTATCTTTGGA
CCGAGGCGGGT -> CGAGGCGGGTG
GTTAGCAGAAC -> TTAGCAGAACG
AGAAGACAAGC -> GAAGACAAGCT
AGTAAAGGCTG -> GTAAAGGCTGC
CTTAACCATAA -> TTAACCATAAT
GCGTTCCTGAC -> CGTTCCTGACG
TTATTAGCTAA -> TATTAGCTAAG
GGCACAATCAG -> GCACAATCAGC
CCCCCACCGCG -> CCCCACCGCGT
TAAGGTATAAC -> AAGGTATAACG
AGTGATGCCGT -> GTGATGCCGTA
GTGGGGACGGG -> TGGGGACGGGA
GGGCGAGCCCG -> GGCGAGCCCGA
GGCTCACTTTC -> GCTCACTTTCG
CGCGGCCGAGT -> GCGGCCGAGTC
CTATCTTTGGA -> TATCTTTGGAC
CTACTACCAGC -> TACTACCAGCT
CCGTAGCGTAT -> CGTAGCGTATA
CCACCGCGTTC -> CACCGCGTTCC
CGATTATGCAC -> GATTATGCACC
TAGTAACTCCG -> AGTAACTCCGA
TACCTCCCAAG -> ACCTCCCAAGC
TCATCCCCATA -> CATCCCCATAC
GCGGGTGGTAC -> CGGGTGGTACA
TGTCAGTATTG -> GTCAGTATTGC
AGTAGGTTCTA -> GTAGGTTCTAA
TATGGGTCTTC -> ATGGGTCTTCT
CCCCATCAATG -> CCCATCAATGT
AAATTTAATTG -> AATTTAATTGC
GGGCCGGCCAC -> GGCCGGCCACC
CGTCTCAAGTG -> GTCTCAAGTGA
GGACTAAAGTC -> GACTAAAGTCT
CTGAAATTTAA -> TGAAATTTAAT
TGGGGTCCTTG -> GGGGTCCTTGA
TCAGCCTTAAC -> CAGCCTTAACT
CGCACTCGAAT -> GCACTCGAATC
TAAATTATAGG -> AAATTATAGGT
CTGTGACGACC -> TGTGACGACCA
CACCGCAGGCG -> ACCGCAGGCGA
GTTATCGTCTC -> TTATCGTCTCA
GTACAAGGAGT -> TACAAGGAGTC
ATGTAGACCCA -> TGTAGACCCAT
AAGTCGGGCTA -> AGTCGGGCTAT
ACGGGTACCCT -> CGGGTACCCTT
TATGGGAGATG -> ATGGGAGATGT
AGGCTTAGTAA -> GGCTTAGTAAC
CTGTACAGTAT -> TGTACAGTATC
GGTCCTTGAAA -> GTCCTTGAAAT
TCAAGCCGGGA -> CAAGCCGGGAA
CGTCTCATGTA -> GTCTCATGTAG
CCCTTAAGTGT -> CCTTAAGTGTA
TAACCTAGTTG -> AACCTAGTTGG
ACCCTCTAAGC -> CCCTCTAAGCT
ATCCACACTTA -> TCCACACTTAA
TCCTATCTTTG -> CCTATCTTTGG
TTACCGAAAAC -> TACCGAAAACA
GATTCTCAATA -> ATTCTCAATAC
TTGTCGTACAA -> TGTCGTACAAG
GAACTACTACC -> AACTACTACCA
ACTGGCGGGTT -> CTGGCGGGTTC
CTCAAATCCTA -> TCAAATCCTAC
ATAAATGACAA -> TAAATGACAAA
CCCCCTCTCTA -> CCCCTCTCTAT
CACTTCAGCCT -> ACTTCAGCCTC
GGGAGATGTAG -> GGAGATGTAGA
CTAGGGCCGGC -> TAGGGCCGGCC
CTCTATGTTTA -> TCTATGTTTAC
TACTAGACGGG -> ACTAGACGGGT
GAATTGTTAAT -> AATTGTTAATC
TTAACCACGTC -> TAACCACGTCC
TGACAAACACT -> GACAAACACTT
GGAAGCTTGTC -> GAAGCTTGTCG
ACGACACGCGC -> CGACACGCGCG
CTGCCGGGCTT -> TGCCGGGCTTA
AGGCGAGCAGT -> GGCGAGCAGTG
ACACGACCCTC -> CACGACCCTCT
CTGGGTACTCC -> TGGGTACTCCA
TGCTGCGGTAC -> GCTGCGGTACA
CCATACGGTCT -> CATACGGTCTC
CGTTGCCCGCG -> GTTGCCCGCGT
AACATTTCAGC -> ACATTTCAGCC
AGGAAGTAAAG -> GGAAGTAAAGG
GAGGTTATCGT -> AGGTTATCGTC
ACACCAGCTGC -> CACCAGCTGCG
GAAGTATCGAT -> AAGTATCGATG
TCTCATCTGGA -> CTCATCTGGAC
TTAGCAGAACG -> TAGCAGAACGA
TAGTTATTAGC -> AGTTATTAGCT
TTCTGTACAGT -> TCTGTACAGTA
ACTCTCGTCTC -> CTCTCGTCTCA
GTATCGCAAAC -> TATCGCAAACC
AATTCTTATAG -> ATTCTTATAGT
CTGTATTCCGC -> TGTATTCCGCC
CCGAGCACCAG -> CGAGCACCAGG
CTCATCTGGAC -> TCATCTGGACT
TACTGGCGGGT -> ACTGGCGGGTT
GTGGGGGATAC -> TGGGGGATACT
TTTAGGGGCAA -> TTAGGGGCAAG
TCTATCTGGCC -> CTATCTGGCCA
ACTTTCGTAGG -> CTTTCGTAGGA
TAAGCGGGGGA -> AAGCGGGGGAA
TTTTAGGGGCA -> TTTAGGGGCAA
GCGCGTTCCTG -> CGCGTTCCTGA
GCGTATAAACC -> CGTATAAACCA
ACCTCCAGCAA -> CCTCCAGCAAA
GTTGGTAGTTA -> TTGGTAGTTAT
ACCATTATTAA -> CCATTATTAAC
CGGCAGAAGAC -> GGCAGAAGACA
ACGAATACTGC -> CGAATACTGCG
GGACCCCTGTC -> GACCCCTGTCA
TAAGGAAGTAA -> AAGGAAGTAAA
CCCTGAGGGGG -> CCTGAGGGGGT
CTGGCCATAAT -> TGGCCATAATC
CCGAAAACAAT -> CGAAAACAATA
GACCCTCTAAG -> ACCCTCTAAGC
TAGCGTATAAA -> AGCGTATAAAC
TTACAGGATGA -> TACAGGATGAG
GCTTAGTAACT -> CTTAGTAACTC
AGAAGTTACGG -> GAAGTTACGGA
CACTCGACACC -> ACTCGACACCA
CGAGTCGCAAC -> GAGTCGCAACC
AACTCCGAACT -> ACTCCGAACTG
GCGTTCCAACC -> CGTTCCAACCA
TACTGGATTAC -> ACTGGATTACC
ACTCGATTATG -> CTCGATTATGC
GATTGGTAAGC -> ATTGGTAAGCT
TCGTCGATTGG -> CGTCGATTGGA
AAGTCTGGTGC -> AGTCTGGTGCA
CTACTACCATC -> TACTACCATCT
GCACCATAACC -> CACCATAACCG
GGCCATAATCC -> GCCATAATCCA
GGTAGAGAGGC -> GTAGAGAGGCA
ATAAACCATAT -> TAAACCATATT
ATTACGACGAG -> TTACGACGAGA
ATTGCCTTTGG -> TTGCCTTTGGG
AGCGTATAAAC -> GCGTATAAACC
ACGGGAAGGTC -> CGGGAAGGTCT
CGACACGCGCG -> GACACGCGCGT
CGGGTACCCTT -> GGGTACCCTTA
TTGAGCTATAC -> TGAGCTATACC
CTGCGGTACAC -> TGCGGTACACA
CGGACTCTATG -> GGACTCTATGT
GCAAGTGGATC -> CAAGTGGATCA
TAACTCCGAAC -> AACTCCGAACT
ATCGTTATACT -> TCGTTATACTG
TGTTTGCTCGG -> GTTTGCTCGGA
GGCTTAGACAA -> GCTTAGACAAA
CATGTTTGCTA -> ATGTTTGCTAT
GCAGCGCGTTC -> CAGCGCGTTCC
ATGAAGCTATG -> TGAAGCTATGT
GGCCGAGTCGC -> GCCGAGTCGCA
TACGATACTAG -> ACGATACTAGA
GTATACTAGGA -> TATACTAGGAT
AGCATAAGGAT -> GCATAAGGATC
GGAAGCAGAAT -> GAAGCAGAATA
CTGTGTACCGC -> TGTGTACCGCG
CCCACCACGGG -> CCACCACGGGA
AACTAATAAAT -> ACTAATAAATG
GCCGTGAAGAA -> CCGTGAAGAAA
GAAATGCAAGC -> AAATGCAAGCT
CTTTTGCTAAC -> TTTTGCTAACT
GACAAGCTGCC -> ACAAGCTGCCG
TCGGGCTATAT -> CGGGCTATATA
ACGCCGATTGG -> CGCCGATTGGT
CCTCTAAGCTG -> CTCTAAGCTGA
GTACGCTACAT -> TACGCTACATG
AAGAAATGCAA -> AGAAATGCAAG
CGCGCGTGTTT -> GCGCGTGTTTA
CCAAGACCGGG -> CAAGACCGGGG
AATCGTTATAC -> ATCGTTATACT
CTAAGCTGATA -> TAAGCTGATAG
GGCCTGCTCGT -> GCCTGCTCGTG
TGCATAATTAC -> GCATAATTACG
CTCGACACCAG -> TCGACACCAGC
GCGCACTCGAA -> CGCACTCGAAT
ATCGTCTCAAG -> TCGTCTCAAGT
CGCCCCCACCG -> GCCCCCACCGC
CCCTCTCTATC -> CCTCTCTATCT
CGTACCTCCCA -> GTACCTCCCAA
TGTAGCGGTAC -> GTAGCGGTACG
TCCTGACGCCC -> CCTGACGCCCC
ACAAGCTGCCG -> CAAGCTGCCGG
TAGAACCTCTG -> AGAACCTCTGT
GGCTGGCAGTC -> GCTGGCAGTCA
GACGAATACTG -> ACGAATACTGC
GTCCCCATCAA -> TCCCCATCAAT
CACCGCGTTCC -> ACCGCGTTCCA
CGTAGAACCTC -> GTAGAACCTCT
ACCAGTGGCAT -> CCAGTGGCATT
CAATACTCAAA -> AATACTCAAAC
TGTAGGTAGAG -> GTAGGTAGAGA
GTGCATGGTCT -> TGCATGGTCTG
CTTAACTGAAA -> TTAACTGAAAT
CAATATTTCTG -> AATATTTCTGT
CATCCCCATAC -> ATCCCCATACT
GCTCCTCCATA -> CTCCTCCATAC
TCATCTGGACT -> CATCTGGACTA
GTTCCTGACGC -> TTCCTGACGCC
TCAGCCTCTCT -> CAGCCTCTCTC
GCCGTAGCGTA -> CCGTAGCGTAT
GCAAGGCTTAG -> CAAGGCTTAGT
GCTGTTGGTCC -> CTGTTGGTCCA
TAATTAACATG -> AATTAACATGG
ACTCGACACCA -> CTCGACACCAG
GATACTAGACG -> ATACTAGACGG
AAACCATATTG -> AACCATATTGT
CCATTATTAAC -> CATTATTAACC
GGGAAGTATCG -> GGAAGTATCGA
TTCTCAATACG -> TCTCAATACGC
TCCCCATACTG -> CCCCATACTGT
AATGCAAGCTG -> ATGCAAGCTGT
AGCAACCCTGA -> GCAACCCTGAG
CCTTGTTATAA -> CTTGTTATAAT
TGGACGATTCT -> GGACGATTCTC
AACTCTTCCCC -> ACTCTTCCCCT
TAATGCACATT -> AATGCACATTA
GGAGTCACAAG -> GAGTCACAAGA
TTTCATAATTG -> TTCATAATTGA
AGTCGTCGATT -> GTCGTCGATTG
AAGACAAGCTG -> AGACAAGCTGC
ATTACCAAACC -> TTACCAAACCA
ATGACAAACAC -> TGACAAACACT
TGGATTACCAA -> GGATTACCAAA
AACCATAATAC -> ACCATAATACG
ATCAAGCCGGG -> TCAAGCCGGGA
ACCGAACTACT -> CCGAACTACTA
GGAGCCTCTCG -> GAGCCTCTCGG
TACAGCGACAG -> ACAGCGACAGC
CCTTGTAACTA -> CTTGTAACTAA
ACTGAAATTTA -> CTGAAATTTAA
TTCGGCAGAAG -> TCGGCAGAAGA
TAAGGACATGT -> AAGGACATGTG
ACCGTAAATTA -> CCGTAAATTAT
GAAATTTAATT -> AAATTTAATTG
CTGTTAGCAGA -> TGTTAGCAGAA
GGTGACCTTGG -> GTGACCTTGGC
CCGAGGTTATC -> CGAGGTTATCG
TCCAGCAAACA -> CCAGCAAACAT
CCACCCAGGCT -> CACCCAGGCTC
TATGTATGTAG -> ATGTATGTAGG
ATACGCATCAG -> TACGCATCAGT
CTCAATACGCC -> TCAATACGCCG
GTAACTCCGAA -> TAACTCCGAAC
CTCTCGGAACT -> TCTCGGAACTT
GTGGGAGAAGT -> TGGGAGAAGTT
CCCTCTAAGCT -> CCTCTAAGCTG
CCTTGGCAAGG -> CTTGGCAAGGC
TCTCTATCTGG -> CTCTATCTGGC
TACCCTTTCCA -> ACCCTTTCCAA
GAAGCGCTGCA -> AAGCGCTGCAT
ACCGTGCATGG -> CCGTGCATGGT
TCAAATCCTAC -> CAAATCCTACC
TACACGACCCT -> ACACGACCCTC
AAAAGCCCACC -> AAAGCCCACCA
CTCGGAGGCTC -> TCGGAGGCTCC
AGGGGCGCTTA -> GGGGCGCTTAA
CCAGCTTTCAA -> CAGCTTTCAAT
GCATAAACCTC -> CATAAACCTCC
CACCAGCTGCG -> ACCAGCTGCGT
TGCGCTTGTCG -> GCGCTTGTCGT
CTCTCGTCCGG -> TCTCGTCCGGC
CTTGTCGTACA -> TTGTCGTACAA
ACCTTGGCAAG -> CCTTGGCAAGG
AAGCTGCCGGG -> AGCTGCCGGGC
GGATATCATCC -> GATATCATCCC
TGCACATTAGC -> GCACATTAGCG
AATCCTACCCT -> ATCCTACCCTT
ATAATTGAGCT -> TAATTGAGCTA
CCACACTTAAT -> CACACTTAATG
GTTAATCCGTA -> TTAATCCGTAG
TCAATACGCCG -> CAATACGCCGA
TGTGTACCGCG -> GTGTACCGCGG
AGTGGGAGAAG -> GTGGGAGAAGT
CTTGAAATCAA -> TTGAAATCAAG
GTACTCCAGCA -> TACTCCAGCAA
GCAAACCCACA -> CAAACCCACAC
CCAGGTTCCGT -> CAGGTTCCGTT
GAGACCGCAGA -> AGACCGCAGAC
CTTGACCATTA -> TTGACCATTAT
TCTCGTCTCAT -> CTCGTCTCATG
GATGAAGCTAT -> ATGAAGCTATG
CCCCTCTCTAT -> CCCTCTCTATC
CCGACGATTAC -> CGACGATTACG
CCCGAGGTTAT -> CCGAGGTTATC
CCCATCAATGT -> CCATCAATGTA
GGCCACCCAGG -> GCCACCCAGGC
TGGCAGTCAAT -> GGCAGTCAATA
AGCTTTCAATA -> GCTTTCAATAA
TCTGGAGGCGA -> CTGGAGGCGAT
GGGTCCTTGAA -> GGTCCTTGAAA
TTTGCTCGGAG -> TTGCTCGGAGG
GGGGCAAGAAT -> GGGCAAGAATT
TGGACCCGAGG -> GGACCCGAGGT
GTAGCGTATAA -> TAGCGTATAAA
ATTCTCTGGAG -> TTCTCTGGAGG
GACCTGCTGTA -> ACCTGCTGTAG
CGCTACATGTT -> GCTACATGTTT
GATTACGATAC -> ATTACGATACT
TTATAGGTAAG -> TATAGGTAAGG
ATGATGAAGCT -> TGATGAAGCTA
CTTGTCGGGGA -> TTGTCGGGGAG
CATATGTGCAT -> ATATGTGCATA
CGCGACCAATC -> GCGACCAATCC
GGGTACCCTTA -> GGTACCCTTAA
AGCAAACATTT -> GCAAACATTTC
CGGGAAGTATC -> GGGAAGTATCG
GACGCGATCGC -> ACGCGATCGCT
CATTAGCGCAA -> ATTAGCGCAAG
TATTGCGACGA -> ATTGCGACGAA
ACCAGCTGCGT -> CCAGCTGCGTC
CCCTTGTTATA -> CCTTGTTATAA
TCCCCATCAAT -> CCCCATCAATG
GAATAAGATTT -> AATAAGATTTA
CGTCTAGAGTC -> GTCTAGAGTCT
TATTAACCTGT -> ATTAACCTGTA
GCTTTTGCTAA -> CTTTTGCTAAC
ATTCGGCAGAA -> TTCGGCAGAAG
AATAAATGACA -> ATAAATGACAA
CAGTATTGCGA -> AGTATTGCGAC
AGGGGAGTGCA -> GGGGAGTGCAG
AGAGGCAATTC -> GAGGCAATTCT
AAAACAATAAT -> AAACAATAATT
GTGTTATTAAG -> TGTTATTAAGC
TATACTGGATT -> ATACTGGATTA
CTGCTCGTGGG -> TGCTCGTGGGG
TACTGCGCACT -> ACTGCGCACTC
TCTCTGGAGGC -> CTCTGGAGGCG
AGGTAGAGAGG -> GGTAGAGAGGC
GGGTACTCCAG -> GGTACTCCAGC
CCGCAGACCTG -> CGCAGACCTGC
ACGCGCGTGTT -> CGCGCGTGTTT
CAAGCTGTTGG -> AAGCTGTTGGT
TTTCTGTACAG -> TTCTGTACAGT
CACGGGACTGG -> ACGGGACTGGA
AAGACCGGGGC -> AGACCGGGGCG
CCCCTGTCAGT -> CCCTGTCAGTA
AACACTTCAGC -> ACACTTCAGCC
TAAGCTAAGTC -> AAGCTAAGTCG
ACTAATAAATG -> CTAATAAATGA
TAATCCGTAGA -> AATCCGTAGAA
GAAGCAGAATA -> AAGCAGAATAA
GTAAATTATAG -> TAAATTATAGG
CCGAACTGGCC -> CGAACTGGCCT
GTGACCCGTGG -> TGACCCGTGGC
GATACTGGCGG -> ATACTGGCGGG
CAGCAACCCTG -> AGCAACCCTGA
GGTGCATAAAC -> GTGCATAAACC
TCGTGGGGGAT -> CGTGGGGGATA
GCTACATGTTT -> CTACATGTTTG
CTCGAATCGTT -> TCGAATCGTTA
TTAACATGGGG -> TAACATGGGGT
CAAACCATGAT -> AAACCATGATC
AAGGCTGCGTT -> AGGCTGCGTTT
ACTCAAACGCA -> CTCAAACGCAG
CGATACTAGAC -> GATACTAGACG
TTGGTAGTTAT -> TGGTAGTTATT
ATGCCGTAGCG -> TGCCGTAGCGT
TGATTACCGAA -> GATTACCGAAA
CCTACCCTTTC -> CTACCCTTTCC
TACATGTTTGC -> ACATGTTTGCT
ACAATCAGCCT -> CAATCAGCCTT
GCGATAACCTA -> CGATAACCTAG
GTTACGGACAA -> TTACGGACAAC
CAGTAAGGTAT -> AGTAAGGTATA
GTAGCGGTACG -> TAGCGGTACGG
CAGCTTTCAAT -> AGCTTTCAATA
GTCTCAAGTGA -> TCTCAAGTGAT
AGACGGGTTCC -> GACGGGTTCCT
ACTTAACCATA -> CTTAACCATAA
CGTCCGGCCTG -> GTCCGGCCTGC
GCTAACTACTA -> CTAACTACTAC
GTCGTCGATTG -> TCGTCGATTGG
GAGCACCAGGG -> AGCACCAGGGG
CTCTCTATCTG -> TCTCTATCTGG
TGGGAAAACTC -> GGGAAAACTCT
AGCTTGTCGGG -> GCTTGTCGGGG
TAGGTAGAGAG -> AGGTAGAGAGG
AGATGTAGACC -> GATGTAGACCC
TAAACCATATT -> AAACCATATTG
TGCCGTAGCGT -> GCCGTAGCGTA
AAACCATGATC -> AACCATGATCG
GCGGTACACAT -> CGGTACACATC
TATCGATGATG -> ATCGATGATGA
GTAGGACCCCC -> TAGGACCCCCT
ATTCTCAATAC -> TTCTCAATACG
ATGCACATTAG -> TGCACATTAGC
TTTCAGCCGGC -> TTCAGCCGGCT
AGTCACAAGAC -> GTCACAAGACG
ATCTCGTGACC -> TCTCGTGACCC
GGTAAGCTAAG -> GTAAGCTAAGT
AATGACAAACA -> ATGACAAACAC
CATCAATGTAT -> ATCAATGTATA
TATCTGGCCAT -> ATCTGGCCATA
TACAAGGAGTC -> ACAAGGAGTCA
TTATAATTAAC -> TATAATTAACA
TGGTACATATG -> GGTACATATGT
CGCAGAAAACT -> GCAGAAAACTT
TAAGGATCAGA -> AAGGATCAGAA
CGCAGGGGCGC -> GCAGGGGCGCT
TATGCACCATA -> ATGCACCATAA
AGTGCAGCTAC -> GTGCAGCTACC
TAATTACGACG -> AATTACGACGA
CGGGTTCCTAT -> GGGTTCCTATC
AAAACTCTTCC -> AAACTCTTCCC
TCCCAAGCGCG -> CCCAAGCGCGA
AACCATTCTCT -> ACCATTCTCTG
TCGAATCGTTA -> CGAATCGTTAT
GGCTCCCTCGG -> GCTCCCTCGGA
TCTCGGAACTT -> CTCGGAACTTA
AAGCGCTGCAT -> AGCGCTGCATC
ATGTGGGGACG -> TGTGGGGACGG
GTTCCGTTGCC -> TTCCGTTGCCC
AAGGATCAGAA -> AGGATCAGAAG
ACGGGACTGGA -> CGGGACTGGAA
CGCTTGTCGTA -> GCTTGTCGTAC
ACCTAGTTGGT -> CCTAGTTGGTA
AGGTTATCGTC -> GGTTATCGTCT
TCCCCTAAGGC -> CCCCTAAGGCA
TGAAGCGCTGC -> GAAGCGCTGCA
ACTGGCCTTGC -> CTGGCCTTGCT
ACCCATGCTCC -> CCCATGCTCCT
CACACTTAATG -> ACACTTAATGC
ACTACCAGCTT -> CTACCAGCTTT
TCAGCCGGCTA -> CAGCCGGCTAG
GCGCTTAATTT -> CGCTTAATTTA
GTTATACTGGA -> TTATACTGGAT
GAAACGCAGAA -> AAACGCAGAAA
CGTATAAACCA -> GTATAAACCAT
TAACGCCCAGG -> AACGCCCAGGT
GGGGAGTGCAG -> GGGAGTGCAGC
ACCATAATACG -> CCATAATACGC
CCTTACACGAC -> CTTACACGACC
ATAACCTAGTT -> TAACCTAGTTG
GCTGCGTCCCT -> CTGCGTCCCTT
GTATTCCGCCT -> TATTCCGCCTA
CAAGCTGCCGG -> AAGCTGCCGGG
CACCACGGGAC -> ACCACGGGACT
TGCGGTACACA -> GCGGTACACAT
ATTCTTATAGT -> TTCTTATAGTG
TTCCTGACGCC -> TCCTGACGCCC
ATTGTTTGCTC -> TTGTTTGCTCG
AACCTCCAGCA -> ACCTCCAGCAA
ATTTATGGGTC -> TTTATGGGTCT
AGGAGACTTTA -> GGAGACTTTAC
GAAACTCTCGT -> AAACTCTCGTC
CGCCGATTGGT -> GCCGATTGGTA
GCGTCCCTTGT -> CGTCCCTTGTT
GCTTGACCATT -> CTTGACCATTA
GTAGATTCGGC -> TAGATTCGGCA
CTCGTCCGGCC -> TCGTCCGGCCT
AGCCTCTCGGA -> GCCTCTCGGAA
TACGACGAGAC -> ACGACGAGACG
CCTTGCTTGAC -> CTTGCTTGACC
AAACAATAATT -> AACAATAATTA
TTGCTTGACCA -> TGCTTGACCAT
CTAGCATAAGG -> TAGCATAAGGA
CATGGGGTTAT -> ATGGGGTTATG
GGAACTTACGT -> GAACTTACGTG
GCCGGGAAGTA -> CCGGGAAGTAT
GCAGAATAAGA -> CAGAATAAGAT
GATTGGAGACC -> ATTGGAGACCG
TCGGGGACCCC -> CGGGGACCCCT
AAGGAAGTAAA -> AGGAAGTAAAG
CAAAAGCCCAC -> AAAAGCCCACC
GATATCATCCC -> ATATCATCCCC
TTGCTATGGGA -> TGCTATGGGAG
ACAGGATGAGT -> CAGGATGAGTA
CGCCTTGTAAC -> GCCTTGTAACT
AGGATGAGTAC -> GGATGAGTACG
AGCTGCGTCCC -> GCTGCGTCCCT
GGCAGAAGACA -> GCAGAAGACAA
GGCTGACGGCC -> GCTGACGGCCT
TCGGACTCTAT -> CGGACTCTATG
AGAGAGGCAAT -> GAGAGGCAATT
TGCTATGGGAG -> GCTATGGGAGA
TTGGACGATTC -> TGGACGATTCT
TTATAGTGGGA -> TATAGTGGGAG
CCCGCGTACCT -> CCGCGTACCTC
ACGACCAGTGG -> CGACCAGTGGC
GCTCCCTCGGA -> CTCCCTCGGAC
GCTTGTCGGGG -> CTTGTCGGGGA
CATTGAAGCAG -> ATTGAAGCAGC
GCGAGCCCGAG -> CGAGCCCGAGG
CTCCCAAGCGC -> TCCCAAGCGCG
ACTTCAGCCTC -> CTTCAGCCTCT
GGTACCCTTAA -> GTACCCTTAAG
ATCCTACCCTT -> TCCTACCCTTT
CCATTGAAGCA -> CATTGAAGCAG
CTGGAGGCGAT -> TGGAGGCGATA
TATAGGTAAGG -> ATAGGTAAGGA
GGAAGGTCTAG -> GAAGGTCTAGG
AGGCGGGTGGT -> GGCGGGTGGTA
CGACCCTCTAA -> GACCCTCTAAG
CTAATAAATGA -> TAATAAATGAC
CATCTGTGAAA -> ATCTGTGAAAC
CAATGTATACT -> AATGTATACTA
CATTTCATAAT -> ATTTCATAATT
AGGTGACCTTG -> GGTGACCTTGG
CAGGATGAGTA -> AGGATGAGTAC
AGAACGACACG -> GAACGACACGC
GATGAGTACGC -> ATGAGTACGCT
CCTGTATTCCG -> CTGTATTCCGC
ACTGGATTACC -> CTGGATTACCA
CCCATACTGTT -> CCATACTGTTA
CATAATTACGA -> ATAATTACGAC
AAGCTATGTAT -> AGCTATGTATG
GTGTAGATTCG -> TGTAGATTCGG
GCACATTAGCG -> CACATTAGCGC
TTACGACGAGA -> TACGACGAGAC
CTTTGGGAAAA -> TTTGGGAAAAC
TAAGGCAGACC -> AAGGCAGACCG
TCCCGAGCACC -> CCCGAGCACCA
GTCCGTTTCGC -> TCCGTTTCGCC
CCTGACGCCCC -> CTGACGCCCCC
CATGCTGCGGT -> ATGCTGCGGTA
GTCCATGATTA -> TCCATGATTAC
AGGCTCCCTCG -> GGCTCCCTCGG
CAATCCGACGA -> AATCCGACGAT
GTGGCACAATC -> TGGCACAATCA
TAGAGAGGCAA -> AGAGAGGCAAT
TACCGGGTCCC -> ACCGGGTCCCC
ATCGCAAACCC -> TCGCAAACCCA
AGATTCGGCAG -> GATTCGGCAGA
TGGCACAATCA -> GGCACAATCAG
GTATAAACCAT -> TATAAACCATA
GCAAACATTTC -> CAAACATTTCA
GACGTCTAGAG -> ACGTCTAGAGT
TTCAGCCTCTC -> TCAGCCTCTCT
TGACCTTGGCA -> GACCTTGGCAA
AATACGCCGAT -> ATACGCCGATT
GATAACCTAGT -> ATAACCTAGTT
AGGACATGTGG -> GGACATGTGGG
TTAGGCTGGCA -> TAGGCTGGCAG
CGGGGCGAGCC -> GGGGCGAGCCC
GGAAGTAAAGG -> GAAGTAAAGGC
GAAGCTATGTA -> AAGCTATGTAT
ATTTAATTGCC -> TTTAATTGCCT
ACGCCCCCACC -> CGCCCCCACCG
ACATTTCAGCC -> CATTTCAGCCG
ACATTAGCGCA -> CATTAGCGCAA
CAAACACTTCA -> AAACACTTCAG
CGCAACCATCC -> GCAACCATCCA
GGATGAGTACG -> GATGAGTACGC
AGAATTGTTAA -> GAATTGTTAAT
GGACTCTATGT -> GACTCTATGTT
TGGAGACCGCA -> GGAGACCGCAG
ATACTGGCGGG -> TACTGGCGGGT
TATACTAGGAT -> ATACTAGGATA
GGCCTTACACG -> GCCTTACACGA
CCCTAAGGCAG -> CCTAAGGCAGA
TTTCAATAACA -> TTCAATAACAT
TAGGGTGGCAA -> AGGGTGGCAAT
GTCGCAACCAT -> TCGCAACCATC
AGTTATTAGCT -> GTTATTAGCTA
AACGACACGCG -> ACGACACGCGC
CCACGGGACTG -> CACGGGACTGG
GGACAACTTTC -> GACAACTTTCC
CGTCCGTTTCG -> GTCCGTTTCGC
GGGTCTTCTGT -> GGTCTTCTGTG
CGCTTAATTTA -> GCTTAATTTAT
AGGCGATAACC -> GGCGATAACCT
TTATGGGTCTT -> TATGGGTCTTC
GGTTTTGACTC -> GTTTTGACTCG
CCCAAGCGCGA -> CCAAGCGCGAC
CCTAGGGCCGG -> CTAGGGCCGGC
AAACGCAGAAA -> AACGCAGAAAA
TCCGGCCTGCT -> CCGGCCTGCTC
TGTACAGTATC -> GTACAGTATCG
AGACTTTACGG -> GACTTTACGGG
TCTCAAGTGAT -> CTCAAGTGATG
GTCTAGAGTCT -> TCTAGAGTCTG
GAGTGCAGCTA -> AGTGCAGCTAC
TACAGGATGAG -> ACAGGATGAGT
TAGACAAAAGC -> AGACAAAAGCC
ACATGGGGTTA -> CATGGGGTTAT
TAAGCCGTGAA -> AAGCCGTGAAG
TACCGCGGCCG -> ACCGCGGCCGA
TTTGGGAAAAC -> TTGGGAAAACT
CTTACACGACC -> TTACACGACCC
CCCTCGGACTC -> CCTCGGACTCT
TAGCATAAGGA -> AGCATAAGGAT
CCATTCTCTGG -> CATTCTCTGGA
GTCTGAAGCGC -> TCTGAAGCGCT
TCGATTATGCA -> CGATTATGCAC
ACGTCTAGAGT -> CGTCTAGAGTC
GAACTTACGTG -> AACTTACGTGC
GTCTCATCTGG -> TCTCATCTGGA
ACACTTCAGCC -> CACTTCAGCCT
TTCAGCCGGCT -> TCAGCCGGCTA
GCCCCCACCGC -> CCCCCACCGCG
ATCAGAGAACT -> TCAGAGAACTT
GGTTCTTACAG -> GTTCTTACAGG
GAAGTTACGGA -> AAGTTACGGAC
GCTGACGGCCT -> CTGACGGCCTT
ATAAGGATCAG -> TAAGGATCAGA
TGGGGGATACT -> GGGGGATACTG
GGTAAGGAAGT -> GTAAGGAAGTA
GGTATAACGCC -> GTATAACGCCC
TAATACAGCGA -> AATACAGCGAC
CCTGCTCGTGG -> CTGCTCGTGGG
GGCGAGCCCGA -> GCGAGCCCGAG
GGATACTGGCG -> GATACTGGCGG
ACCATATTGTT -> CCATATTGTTT
AGTGTTATTAA -> GTGTTATTAAG
TGACCATTATT -> GACCATTATTA
TTGGAGACCGC -> TGGAGACCGCA
CTCTCTCGTCC -> TCTCTCGTCCG
CAAGCCGGGAA -> AAGCCGGGAAG
CAGAATAAGAT -> AGAATAAGATT
ACCATGATCGA -> CCATGATCGAC
ACTCCAGCAAC -> CTCCAGCAACC
AGACGTTAGGC -> GACGTTAGGCT
TGAAATTTAAT -> GAAATTTAATT
AGCTGGGTACT -> GCTGGGTACTC
CAGCAAACATT -> AGCAAACATTT
GCCCGCGTACC -> CCCGCGTACCT
ACGACGAGACG -> CGACGAGACGT
ATGATTACCGA -> TGATTACCGAA
TATTGTTTGCT -> ATTGTTTGCTC
CATGTAGCGGT -> ATGTAGCGGTA
GAACTGGCCTT -> AACTGGCCTTG
CCGGCCTGCTC -> CGGCCTGCTCG
TCGTAGGACCC -> CGTAGGACCCC
CAGTGTTATTA -> AGTGTTATTAA
GAGAGGCAATT -> AGAGGCAATTC
CGAACTGGCCT -> GAACTGGCCTT
CGATTCTCAAT -> GATTCTCAATA
ATGCTGCGGTA -> TGCTGCGGTAC
CATGCTCCTCC -> ATGCTCCTCCA
CTGCGTTTTAG -> TGCGTTTTAGG
GGGAGTGCAGC -> GGAGTGCAGCT
CCTGCTGTAGG -> CTGCTGTAGGT
CTAGGGTGGCA -> TAGGGTGGCAA
AAGCTGTTGGT -> AGCTGTTGGTC
GGAATGCGAGG -> GAATGCGAGGA
GCCGATTGGTA -> CCGATTGGTAA
CCGATTGGTAA -> CGATTGGTAAG
TTACACGACCC -> TACACGACCCT
CCTTGAAATCA -> CTTGAAATCAA
GGCAAGGCTTA -> GCAAGGCTTAG
GGTCCATGATT -> GTCCATGATTA
GCATGGTCTGA -> CATGGTCTGAA
CAAGTGATGCC -> AAGTGATGCCG
TATCGGGGACC -> ATCGGGGACCC
GGTGGCAATAT -> GTGGCAATATT
TACTAGGATAT -> ACTAGGATATC
GGCAATATTTC -> GCAATATTTCT
ATGCACCATAA -> TGCACCATAAC
GGATCAGAAGT -> GATCAGAAGTA
CCTCCAGCAAA -> CTCCAGCAAAC
AATTGCCTTTG -> ATTGCCTTTGG
AGCTAAGCCGT -> GCTAAGCCGTG
TCCATTGAAGC -> CCATTGAAGCA
ACTGCGCACTC -> CTGCGCACTCG
CAGCCTCTCTC -> AGCCTCTCTCG
TGTGGGGACGG -> GTGGGGACGGG
ACGCAGAAAAC -> CGCAGAAAACT
ATACGGTCTCA -> TACGGTCTCAT
GGGCGCTTAAT -> GGCGCTTAATT
CCGGGGCGAGC -> CGGGGCGAGCC
TTGCCCGCGTA -> TGCCCGCGTAC
GGGGAGTCGTC -> GGGAGTCGTCG
ACCGCGGCCGA -> CCGCGGCCGAG
TGGTAAGCTAA -> GGTAAGCTAAG
CAGACCTGCTG -> AGACCTGCTGT
TGTGCATAATT -> GTGCATAATTA
TGCATCGACGG -> GCATCGACGGC
TAGATTCGGCA -> AGATTCGGCAG
AGAACCTCTGT -> GAACCTCTGTG
GCACAATCAGC -> CACAATCAGCC
TGTTTAATACA -> GTTTAATACAG
ACGCAGCTGGG -> CGCAGCTGGGT
AAGTAGGTTCT -> AGTAGGTTCTA
TTGCGACGAAT -> TGCGACGAATA
TTTAATACAGC -> TTAATACAGCG
TTCATAATTGA -> TCATAATTGAG
ACGGCCTTACA -> CGGCCTTACAC
CCCACACTCGA -> CCACACTCGAC
AAGCGGGGGAA -> AGCGGGGGAAG
CATACTGTTAG -> ATACTGTTAGC
TTGTCGGGGAG -> TGTCGGGGAGT
CTTCTGTGTAC -> TTCTGTGTACC
AGGGGCAAGAA -> GGGGCAAGAAT
TATGTGCATAA -> ATGTGCATAAT
TTGTTAATCCG -> TGTTAATCCGT
GTTTACACCGC -> TTTACACCGCA
AGACCTGCTGT -> GACCTGCTGTA
CATGATCGACG -> ATGATCGACGT
GGGACCCCTGT -> GGACCCCTGTC
TCTCGTCCGGC -> CTCGTCCGGCC
ATGCAAGCTGT -> TGCAAGCTGTT
GATTACCAAAC -> ATTACCAAACC
AATGTATACTA -> ATGTATACTAG
CTTAGTAACTC -> TTAGTAACTCC
ACCCGTGGCAC -> CCCGTGGCACA
TAGACGGGTTC -> AGACGGGTTCC
CAGAAAACTTA -> AGAAAACTTAC
ATGTATACTAG -> TGTATACTAGG
AACGCCCAGGT -> ACGCCCAGGTT
GGCCTTGCTTG -> GCCTTGCTTGA
TTATTAAGCGG -> TATTAAGCGGG
CTCGTGGGGGA -> TCGTGGGGGAT
